PokerStars Hand #232991295337:  Hold'em No Limit ($1/$2 USD) - 2022/01/16 10:04:35 ET
Table 'Atalante' 6-max Seat #1 is the button
Seat 1: jimjames32 ($82 in chips)
Seat 2: HHnguyen15 ($96.65 in chips)
Seat 4: kjs609 ($200 in chips)
HHnguyen15: posts small blind $1
kjs609: posts big blind $2
*** HOLE CARDS ***
jimjames32: raises $4 to $6
HHnguyen15: folds
kjs609: folds
Uncalled bet ($4) returned to jimjames32
jimjames32 collected $5 from pot
jimjames32: doesn't show hand
*** SUMMARY ***
Total pot $5 | Rake $0
Seat 1: jimjames32 (button) collected ($5)
Seat 2: HHnguyen15 (small blind) folded before Flop
Seat 4: kjs609 (big blind) folded before Flop


PokerStars Hand #232991295372:  Hold'em No Limit ($1/$2 USD) - 2022/01/16 10:04:44 ET
Table 'Atalante' 6-max Seat #2 is the button
Seat 1: jimjames32 ($85 in chips)
Seat 2: HHnguyen15 ($95.65 in chips)
Seat 4: kjs609 ($198 in chips)
kjs609: posts small blind $1
jimjames32: posts big blind $2
*** HOLE CARDS ***
HHnguyen15: folds
kjs609: folds
Uncalled bet ($1) returned to jimjames32
jimjames32 collected $2 from pot
jimjames32: doesn't show hand
*** SUMMARY ***
Total pot $2 | Rake $0
Seat 1: jimjames32 (big blind) collected ($2)
Seat 2: HHnguyen15 (button) folded before Flop (didn't bet)
Seat 4: kjs609 (small blind) folded before Flop


PokerStars Hand #232991295395:  Hold'em No Limit ($1/$2 USD) - 2022/01/16 10:04:49 ET
Table 'Atalante' 6-max Seat #4 is the button
Seat 1: jimjames32 ($86 in chips)
Seat 2: HHnguyen15 ($95.65 in chips)
Seat 4: kjs609 ($197 in chips)
jimjames32: posts small blind $1
HHnguyen15: posts big blind $2
*** HOLE CARDS ***
kjs609: raises $2 to $4
jimjames32: calls $3
HHnguyen15: calls $2
*** FLOP *** [Jh 4s 3h]
jimjames32: checks
HHnguyen15: checks
kjs609: bets $5.70
jimjames32: folds
HHnguyen15: calls $5.70
*** TURN *** [Jh 4s 3h] [5d]
HHnguyen15: checks
kjs609: bets $11.12
HHnguyen15: calls $11.12
*** RIVER *** [Jh 4s 3h 5d] [5h]
HHnguyen15: checks
kjs609: bets $43.64
HHnguyen15: folds
Uncalled bet ($43.64) returned to kjs609
kjs609 collected $43.64 from pot
kjs609: doesn't show hand
*** SUMMARY ***
Total pot $45.64 | Rake $2
Board [Jh 4s 3h 5d 5h]
Seat 1: jimjames32 (small blind) folded on the Flop
Seat 2: HHnguyen15 (big blind) folded on the River
Seat 4: kjs609 (button) collected ($43.64)


PokerStars Hand #232991295507:  Hold'em No Limit ($1/$2 USD) - 2022/01/16 10:05:19 ET
Table 'Atalante' 6-max Seat #1 is the button
Seat 1: jimjames32 ($82 in chips)
Seat 2: HHnguyen15 ($74.83 in chips)
Seat 4: kjs609 ($219.82 in chips)
HHnguyen15: posts small blind $1
kjs609: posts big blind $2
*** HOLE CARDS ***
jimjames32: raises $4 to $6
HHnguyen15: calls $5
kjs609: folds
*** FLOP *** [Ks 6d 9d]
HHnguyen15: checks
jimjames32: checks
*** TURN *** [Ks 6d 9d] [Qd]
HHnguyen15: checks
jimjames32: checks
*** RIVER *** [Ks 6d 9d Qd] [Qh]
HHnguyen15: bets $13.30
jimjames32: folds
Uncalled bet ($13.30) returned to HHnguyen15
HHnguyen15 collected $13.30 from pot
HHnguyen15: doesn't show hand
*** SUMMARY ***
Total pot $14 | Rake $0.70
Board [Ks 6d 9d Qd Qh]
Seat 1: jimjames32 (button) folded on the River
Seat 2: HHnguyen15 (small blind) collected ($13.30)
Seat 4: kjs609 (big blind) folded before Flop


PokerStars Hand #232991295595:  Hold'em No Limit ($1/$2 USD) - 2022/01/16 10:05:39 ET
Table 'Atalante' 6-max Seat #2 is the button
Seat 1: jimjames32 ($76 in chips)
Seat 2: HHnguyen15 ($82.13 in chips)
Seat 4: kjs609 ($217.82 in chips)
kjs609: posts small blind $1
jimjames32: posts big blind $2
*** HOLE CARDS ***
HHnguyen15: calls $2
kjs609: calls $1
jimjames32: raises $6 to $8
HHnguyen15: calls $6
kjs609: calls $6
*** FLOP *** [2c 4s 3h]
kjs609: checks
jimjames32: checks
HHnguyen15: checks
*** TURN *** [2c 4s 3h] [Kh]
kjs609: checks
jimjames32: checks
HHnguyen15: bets $11.40
kjs609: folds
jimjames32: folds
Uncalled bet ($11.40) returned to HHnguyen15
HHnguyen15 collected $22.80 from pot
HHnguyen15: doesn't show hand
*** SUMMARY ***
Total pot $24 | Rake $1.20
Board [2c 4s 3h Kh]
Seat 1: jimjames32 (big blind) folded on the Turn
Seat 2: HHnguyen15 (button) collected ($22.80)
Seat 4: kjs609 (small blind) folded on the Turn


PokerStars Hand #232991296133:  Hold'em No Limit ($1/$2 USD) - 2022/01/16 10:07:49 ET
Table 'Atalante' 6-max Seat #3 is the button
Seat 1: jimjames32 ($162.23 in chips)
Seat 2: HHnguyen15 ($93.02 in chips)
Seat 3: 3JackOFF ($200 in chips)
jimjames32: posts small blind $1
HHnguyen15: posts big blind $2
*** HOLE CARDS ***
3JackOFF: folds
jimjames32: raises $4 to $6
HHnguyen15: calls $4
*** FLOP *** [5c Qc 2d]
jimjames32: bets $11.40
HHnguyen15: folds
Uncalled bet ($11.40) returned to jimjames32
jimjames32 collected $11.40 from pot
jimjames32: doesn't show hand
*** SUMMARY ***
Total pot $12 | Rake $0.60
Board [5c Qc 2d]
Seat 1: jimjames32 (small blind) collected ($11.40)
Seat 2: HHnguyen15 (big blind) folded on the Flop
Seat 3: 3JackOFF (button) folded before Flop (didn't bet)


PokerStars Hand #232991296177:  Hold'em No Limit ($1/$2 USD) - 2022/01/16 10:08:03 ET
Table 'Atalante' 6-max Seat #1 is the button
Seat 1: jimjames32 ($167.63 in chips)
Seat 2: HHnguyen15 ($87.02 in chips)
Seat 3: 3JackOFF ($200 in chips)
HHnguyen15: posts small blind $1
3JackOFF: posts big blind $2
*** HOLE CARDS ***
jimjames32: raises $4 to $6
HHnguyen15: raises $14 to $20
Pierson2323 joins the table at seat #5
poppy20633 joins the table at seat #6
3JackOFF: folds
jimjames32: calls $14
*** FLOP *** [6h Ts Td]
HHnguyen15: bets $67.02 and is all-in
jimjames32: calls $67.02
*** TURN *** [6h Ts Td] [9c]
*** RIVER *** [6h Ts Td 9c] [Jc]
*** SHOW DOWN ***
HHnguyen15: shows [Ah Jd] (two pair, Jacks and Tens)
jimjames32: shows [7c 7h] (two pair, Tens and Sevens)
HHnguyen15 collected $174.04 from pot
*** SUMMARY ***
Total pot $176.04 | Rake $2
Board [6h Ts Td 9c Jc]
Seat 1: jimjames32 (button) showed [7c 7h] and lost with two pair, Tens and Sevens
Seat 2: HHnguyen15 (small blind) showed [Ah Jd] and won ($174.04) with two pair, Jacks and Tens
Seat 3: 3JackOFF (big blind) folded before Flop


PokerStars Hand #232991296281:  Hold'em No Limit ($1/$2 USD) - 2022/01/16 10:08:30 ET
Table 'Atalante' 6-max Seat #2 is the button
Seat 1: jimjames32 ($80.61 in chips)
Seat 2: HHnguyen15 ($174.04 in chips)
Seat 3: 3JackOFF ($198 in chips)
Seat 4: kjs609 ($209.82 in chips)
3JackOFF: posts small blind $1
kjs609: posts big blind $2
Pierson2323: sits out
poppy20633: sits out
*** HOLE CARDS ***
jimjames32: raises $4 to $6
HHnguyen15: folds
3JackOFF: folds
kjs609: folds
Uncalled bet ($4) returned to jimjames32
jimjames32 collected $5 from pot
jimjames32: doesn't show hand
*** SUMMARY ***
Total pot $5 | Rake $0
Seat 1: jimjames32 collected ($5)
Seat 2: HHnguyen15 (button) folded before Flop (didn't bet)
Seat 3: 3JackOFF (small blind) folded before Flop
Seat 4: kjs609 (big blind) folded before Flop


PokerStars Hand #232991296333:  Hold'em No Limit ($1/$2 USD) - 2022/01/16 10:08:43 ET
Table 'Atalante' 6-max Seat #3 is the button
Seat 1: jimjames32 ($83.61 in chips)
Seat 2: HHnguyen15 ($174.04 in chips)
Seat 3: 3JackOFF ($197 in chips)
Seat 4: kjs609 ($207.82 in chips)
Seat 5: Pierson2323 ($200 in chips)
kjs609: posts small blind $1
Pierson2323: posts big blind $2
poppy20633: sits out
*** HOLE CARDS ***
jimjames32: raises $4 to $6
HHnguyen15: folds
3JackOFF: folds
kjs609: folds
Pierson2323: calls $4
*** FLOP *** [3h As Jc]
Pierson2323: checks
jimjames32: checks
*** TURN *** [3h As Jc] [2s]
Pierson2323: checks
jimjames32: checks
*** RIVER *** [3h As Jc 2s] [6s]
Pierson2323: checks
jimjames32: bets $12.35
Pierson2323: folds
Uncalled bet ($12.35) returned to jimjames32
jimjames32 collected $12.35 from pot
jimjames32: doesn't show hand
*** SUMMARY ***
Total pot $13 | Rake $0.65
Board [3h As Jc 2s 6s]
Seat 1: jimjames32 collected ($12.35)
Seat 2: HHnguyen15 folded before Flop (didn't bet)
Seat 3: 3JackOFF (button) folded before Flop (didn't bet)
Seat 4: kjs609 (small blind) folded before Flop
Seat 5: Pierson2323 (big blind) folded on the River


PokerStars Hand #232991296472:  Hold'em No Limit ($1/$2 USD) - 2022/01/16 10:09:24 ET
Table 'Atalante' 6-max Seat #4 is the button
Seat 1: jimjames32 ($89.96 in chips)
Seat 2: HHnguyen15 ($174.04 in chips)
Seat 3: 3JackOFF ($200 in chips)
Seat 4: kjs609 ($206.82 in chips)
Seat 5: Pierson2323 ($200 in chips)
Pierson2323: posts small blind $1
jimjames32: posts big blind $2
*** HOLE CARDS ***
HHnguyen15: folds
3JackOFF: folds
kjs609: folds
Pierson2323: raises $4 to $6
jimjames32: calls $4
*** FLOP *** [8s 3d 2s]
Pierson2323: checks
jimjames32: checks
*** TURN *** [8s 3d 2s] [9d]
Pierson2323: bets $8
jimjames32: folds
Uncalled bet ($8) returned to Pierson2323
Pierson2323 collected $11.40 from pot
*** SUMMARY ***
Total pot $12 | Rake $0.60
Board [8s 3d 2s 9d]
Seat 1: jimjames32 (big blind) folded on the Turn
Seat 2: HHnguyen15 folded before Flop (didn't bet)
Seat 3: 3JackOFF folded before Flop (didn't bet)
Seat 4: kjs609 (button) folded before Flop (didn't bet)
Seat 5: Pierson2323 (small blind) collected ($11.40)


PokerStars Hand #232991296593:  Hold'em No Limit ($1/$2 USD) - 2022/01/16 10:09:54 ET
Table 'Atalante' 6-max Seat #5 is the button
Seat 1: jimjames32 ($83.96 in chips)
Seat 2: HHnguyen15 ($174.04 in chips)
Seat 3: 3JackOFF ($200 in chips)
Seat 4: kjs609 ($206.82 in chips)
Seat 5: Pierson2323 ($205.40 in chips)
jimjames32: posts small blind $1
HHnguyen15: posts big blind $2
*** HOLE CARDS ***
3JackOFF: folds
kjs609: calls $2
Pierson2323: folds
jimjames32: calls $1
HHnguyen15: checks
*** FLOP *** [Tc Kc 6d]
jimjames32: bets $2
HHnguyen15: folds
kjs609: calls $2
*** TURN *** [Tc Kc 6d] [2d]
jimjames32: bets $9.50
kjs609: folds
Uncalled bet ($9.50) returned to jimjames32
jimjames32 collected $9.50 from pot
jimjames32: doesn't show hand
*** SUMMARY ***
Total pot $10 | Rake $0.50
Board [Tc Kc 6d 2d]
Seat 1: jimjames32 (small blind) collected ($9.50)
Seat 2: HHnguyen15 (big blind) folded on the Flop
Seat 3: 3JackOFF folded before Flop (didn't bet)
Seat 4: kjs609 folded on the Turn
Seat 5: Pierson2323 (button) folded before Flop (didn't bet)


PokerStars Hand #232991296690:  Hold'em No Limit ($1/$2 USD) - 2022/01/16 10:10:21 ET
Table 'Atalante' 6-max Seat #1 is the button
Seat 1: jimjames32 ($89.46 in chips)
Seat 2: HHnguyen15 ($172.04 in chips)
Seat 3: 3JackOFF ($200 in chips)
Seat 4: kjs609 ($202.82 in chips)
Seat 5: Pierson2323 ($205.40 in chips)
HHnguyen15: posts small blind $1
3JackOFF: posts big blind $2
*** HOLE CARDS ***
kjs609: folds
Pierson2323: folds
jimjames32: calls $2
HHnguyen15: calls $1
3JackOFF: checks
*** FLOP *** [5c 6c 7d]
HHnguyen15: checks
3JackOFF: checks
jimjames32: bets $5.70
HHnguyen15: folds
3JackOFF: calls $5.70
*** TURN *** [5c 6c 7d] [Ts]
3JackOFF: checks
jimjames32: checks
*** RIVER *** [5c 6c 7d Ts] [9c]
3JackOFF: bets $10.58
jimjames32: calls $10.58
*** SHOW DOWN ***
3JackOFF: shows [Qd 8s] (a straight, Six to Ten)
jimjames32: mucks hand
3JackOFF collected $36.63 from pot
*** SUMMARY ***
Total pot $38.56 | Rake $1.93
Board [5c 6c 7d Ts 9c]
Seat 1: jimjames32 (button) mucked
Seat 2: HHnguyen15 (small blind) folded on the Flop
Seat 3: 3JackOFF (big blind) showed [Qd 8s] and won ($36.63) with a straight, Six to Ten
Seat 4: kjs609 folded before Flop (didn't bet)
Seat 5: Pierson2323 folded before Flop (didn't bet)


PokerStars Hand #232991296794:  Hold'em No Limit ($1/$2 USD) - 2022/01/16 10:10:51 ET
Table 'Atalante' 6-max Seat #2 is the button
Seat 1: jimjames32 ($71.18 in chips)
Seat 2: HHnguyen15 ($170.04 in chips)
Seat 3: 3JackOFF ($218.35 in chips)
Seat 4: kjs609 ($202.82 in chips)
Seat 5: Pierson2323 ($205.40 in chips)
3JackOFF: posts small blind $1
kjs609: posts big blind $2
*** HOLE CARDS ***
Pierson2323: folds
jimjames32: raises $4 to $6
HHnguyen15: folds
3JackOFF: folds
kjs609: folds
Uncalled bet ($4) returned to jimjames32
jimjames32 collected $5 from pot
jimjames32: doesn't show hand
*** SUMMARY ***
Total pot $5 | Rake $0
Seat 1: jimjames32 collected ($5)
Seat 2: HHnguyen15 (button) folded before Flop (didn't bet)
Seat 3: 3JackOFF (small blind) folded before Flop
Seat 4: kjs609 (big blind) folded before Flop
Seat 5: Pierson2323 folded before Flop (didn't bet)


PokerStars Hand #232991296847:  Hold'em No Limit ($1/$2 USD) - 2022/01/16 10:11:03 ET
Table 'Atalante' 6-max Seat #3 is the button
Seat 1: jimjames32 ($74.18 in chips)
Seat 2: HHnguyen15 ($170.04 in chips)
Seat 3: 3JackOFF ($217.35 in chips)
Seat 4: kjs609 ($200.82 in chips)
Seat 5: Pierson2323 ($205.40 in chips)
kjs609: posts small blind $1
Pierson2323: posts big blind $2
*** HOLE CARDS ***
jimjames32: raises $4 to $6
HHnguyen15: folds
3JackOFF: folds
kjs609: folds
Pierson2323: calls $4
*** FLOP *** [6s 7c Ah]
Pierson2323: checks
jimjames32: bets $6.17
Pierson2323: calls $6.17
*** TURN *** [6s 7c Ah] [Jd]
Pierson2323: bets $12
jimjames32: calls $12
*** RIVER *** [6s 7c Ah Jd] [8s]
Pierson2323: bets $52
jimjames32: folds
Uncalled bet ($52) returned to Pierson2323
Pierson2323 collected $46.87 from pot
Pierson2323: doesn't show hand
*** SUMMARY ***
Total pot $49.34 | Rake $2.47
Board [6s 7c Ah Jd 8s]
Seat 1: jimjames32 folded on the River
Seat 2: HHnguyen15 folded before Flop (didn't bet)
Seat 3: 3JackOFF (button) folded before Flop (didn't bet)
Seat 4: kjs609 (small blind) folded before Flop
Seat 5: Pierson2323 (big blind) collected ($46.87)


PokerStars Hand #232991296991:  Hold'em No Limit ($1/$2 USD) - 2022/01/16 10:11:45 ET
Table 'Atalante' 6-max Seat #4 is the button
Seat 1: jimjames32 ($50.01 in chips)
Seat 2: HHnguyen15 ($170.04 in chips)
Seat 3: 3JackOFF ($217.35 in chips)
Seat 4: kjs609 ($199.82 in chips)
Seat 5: Pierson2323 ($228.10 in chips)
Pierson2323: posts small blind $1
jimjames32: posts big blind $2
*** HOLE CARDS ***
HHnguyen15: folds
3JackOFF: folds
kjs609: calls $2
Pierson2323: folds
jimjames32: raises $48.01 to $50.01 and is all-in
kjs609: folds
Uncalled bet ($48.01) returned to jimjames32
jimjames32 collected $5 from pot
jimjames32: doesn't show hand
*** SUMMARY ***
Total pot $5 | Rake $0
Seat 1: jimjames32 (big blind) collected ($5)
Seat 2: HHnguyen15 folded before Flop (didn't bet)
Seat 3: 3JackOFF folded before Flop (didn't bet)
Seat 4: kjs609 (button) folded before Flop
Seat 5: Pierson2323 (small blind) folded before Flop


PokerStars Hand #232991297076:  Hold'em No Limit ($1/$2 USD) - 2022/01/16 10:12:06 ET
Table 'Atalante' 6-max Seat #5 is the button
Seat 1: jimjames32 ($53.01 in chips)
Seat 2: HHnguyen15 ($170.04 in chips)
Seat 3: 3JackOFF ($217.35 in chips)
Seat 4: kjs609 ($197.82 in chips)
Seat 5: Pierson2323 ($227.10 in chips)
jimjames32: posts small blind $1
HHnguyen15: posts big blind $2
*** HOLE CARDS ***
3JackOFF: folds
kjs609: raises $4 to $6
Pierson2323: folds
jimjames32: raises $47.01 to $53.01 and is all-in
HHnguyen15: folds
kjs609: calls $47.01
*** FLOP *** [5s 4c 5c]
*** TURN *** [5s 4c 5c] [2h]
*** RIVER *** [5s 4c 5c 2h] [6c]
*** SHOW DOWN ***
jimjames32: shows [Ac 3c] (a flush, Ace high)
kjs609: shows [8s 8d] (two pair, Eights and Fives)
jimjames32 collected $105.02 from pot
*** SUMMARY ***
Total pot $108.02 | Rake $3
Board [5s 4c 5c 2h 6c]
Seat 1: jimjames32 (small blind) showed [Ac 3c] and won ($105.02) with a flush, Ace high
Seat 2: HHnguyen15 (big blind) folded before Flop
Seat 3: 3JackOFF folded before Flop (didn't bet)
Seat 4: kjs609 showed [8s 8d] and lost with two pair, Eights and Fives
Seat 5: Pierson2323 (button) folded before Flop (didn't bet)


PokerStars Hand #232991297177:  Hold'em No Limit ($1/$2 USD) - 2022/01/16 10:12:34 ET
Table 'Atalante' 6-max Seat #1 is the button
Seat 1: jimjames32 ($105.02 in chips)
Seat 2: HHnguyen15 ($168.04 in chips)
Seat 3: 3JackOFF ($217.35 in chips)
Seat 4: kjs609 ($144.81 in chips)
Seat 5: Pierson2323 ($227.10 in chips)
HHnguyen15: posts small blind $1
3JackOFF: posts big blind $2
*** HOLE CARDS ***
kjs609: folds
Pierson2323: folds
jimjames32: raises $4 to $6
HHnguyen15: folds
3JackOFF: folds
Uncalled bet ($4) returned to jimjames32
jimjames32 collected $5 from pot
jimjames32: doesn't show hand
*** SUMMARY ***
Total pot $5 | Rake $0
Seat 1: jimjames32 (button) collected ($5)
Seat 2: HHnguyen15 (small blind) folded before Flop
Seat 3: 3JackOFF (big blind) folded before Flop
Seat 4: kjs609 folded before Flop (didn't bet)
Seat 5: Pierson2323 folded before Flop (didn't bet)


PokerStars Hand #232991297216:  Hold'em No Limit ($1/$2 USD) - 2022/01/16 10:12:45 ET
Table 'Atalante' 6-max Seat #2 is the button
Seat 1: jimjames32 ($108.02 in chips)
Seat 2: HHnguyen15 ($167.04 in chips)
Seat 3: 3JackOFF ($215.35 in chips)
Seat 4: kjs609 ($144.81 in chips)
Seat 5: Pierson2323 ($227.10 in chips)
3JackOFF: posts small blind $1
kjs609: posts big blind $2
*** HOLE CARDS ***
Pierson2323: folds
jimjames32: raises $4 to $6
HHnguyen15: calls $6
3JackOFF: raises $26 to $32
kjs609: folds
jimjames32: calls $26
HHnguyen15: folds
*** FLOP *** [7c Tc 5d]
3JackOFF: bets $183.35 and is all-in
jimjames32: calls $76.02 and is all-in
Uncalled bet ($107.33) returned to 3JackOFF
*** TURN *** [7c Tc 5d] [5h]
*** RIVER *** [7c Tc 5d 5h] [3c]
*** SHOW DOWN ***
3JackOFF: shows [9h Ah] (a pair of Fives)
jimjames32: shows [6c 6s] (two pair, Sixes and Fives)
jimjames32 collected $221.04 from pot
*** SUMMARY ***
Total pot $224.04 | Rake $3
Board [7c Tc 5d 5h 3c]
Seat 1: jimjames32 showed [6c 6s] and won ($221.04) with two pair, Sixes and Fives
Seat 2: HHnguyen15 (button) folded before Flop
Seat 3: 3JackOFF (small blind) showed [9h Ah] and lost with a pair of Fives
Seat 4: kjs609 (big blind) folded before Flop
Seat 5: Pierson2323 folded before Flop (didn't bet)


PokerStars Hand #232991297321:  Hold'em No Limit ($1/$2 USD) - 2022/01/16 10:13:15 ET
Table 'Atalante' 6-max Seat #3 is the button
Seat 1: jimjames32 ($221.04 in chips)
Seat 2: HHnguyen15 ($161.04 in chips)
Seat 3: 3JackOFF ($200 in chips)
Seat 4: kjs609 ($198 in chips)
Seat 5: Pierson2323 ($227.10 in chips)
kjs609: posts small blind $1
Pierson2323: posts big blind $2
*** HOLE CARDS ***
jimjames32: raises $4 to $6
HHnguyen15: calls $6
3JackOFF: folds
kjs609: folds
Pierson2323: raises $26 to $32
jimjames32: calls $26
HHnguyen15: folds
*** FLOP *** [Qd 7d 8s]
Pierson2323: bets $23.80
jimjames32: calls $23.80
*** TURN *** [Qd 7d 8s] [5c]
Pierson2323: checks
jimjames32: checks
*** RIVER *** [Qd 7d 8s 5c] [9d]
Pierson2323: checks
jimjames32: checks
*** SHOW DOWN ***
Pierson2323: shows [Jc Jh] (a pair of Jacks)
jimjames32: mucks hand
Pierson2323 collected $115.60 from pot
*** SUMMARY ***
Total pot $118.60 | Rake $3
Board [Qd 7d 8s 5c 9d]
Seat 1: jimjames32 mucked
Seat 2: HHnguyen15 folded before Flop
Seat 3: 3JackOFF (button) folded before Flop (didn't bet)
Seat 4: kjs609 (small blind) folded before Flop
Seat 5: Pierson2323 (big blind) showed [Jc Jh] and won ($115.60) with a pair of Jacks


PokerStars Hand #232991297463:  Hold'em No Limit ($1/$2 USD) - 2022/01/16 10:14:00 ET
Table 'Atalante' 6-max Seat #4 is the button
Seat 1: jimjames32 ($165.24 in chips)
Seat 2: HHnguyen15 ($155.04 in chips)
Seat 3: 3JackOFF ($200 in chips)
Seat 4: kjs609 ($197 in chips)
Seat 5: Pierson2323 ($286.90 in chips)
Seat 6: poppy20633 ($160 in chips)
Pierson2323: posts small blind $1
poppy20633: posts big blind $2
*** HOLE CARDS ***
jimjames32: calls $2
HHnguyen15: folds
3JackOFF: folds
kjs609: calls $2
Pierson2323: raises $10 to $12
poppy20633: folds
jimjames32: calls $10
kjs609: folds
*** FLOP *** [4s Qh Qs]
Pierson2323: bets $9.31
jimjames32: folds
Uncalled bet ($9.31) returned to Pierson2323
Pierson2323 collected $26.60 from pot
*** SUMMARY ***
Total pot $28 | Rake $1.40
Board [4s Qh Qs]
Seat 1: jimjames32 folded on the Flop
Seat 2: HHnguyen15 folded before Flop (didn't bet)
Seat 3: 3JackOFF folded before Flop (didn't bet)
Seat 4: kjs609 (button) folded before Flop
Seat 5: Pierson2323 (small blind) collected ($26.60)
Seat 6: poppy20633 (big blind) folded before Flop


PokerStars Hand #232991297554:  Hold'em No Limit ($1/$2 USD) - 2022/01/16 10:14:24 ET
Table 'Atalante' 6-max Seat #5 is the button
Seat 1: jimjames32 ($153.24 in chips)
Seat 2: HHnguyen15 ($155.04 in chips)
Seat 3: 3JackOFF ($200 in chips)
Seat 4: kjs609 ($195 in chips)
Seat 5: Pierson2323 ($301.50 in chips)
Seat 6: poppy20633 ($158 in chips)
poppy20633: posts small blind $1
jimjames32: posts big blind $2
*** HOLE CARDS ***
HHnguyen15: calls $2
3JackOFF: folds
kjs609: folds
Pierson2323: raises $6 to $8
poppy20633: folds
jimjames32: folds
HHnguyen15: calls $6
*** FLOP *** [8h 7h 5d]
HHnguyen15: checks
Pierson2323: bets $6
HHnguyen15: calls $6
*** TURN *** [8h 7h 5d] [Ad]
HHnguyen15: checks
Pierson2323: bets $22
HHnguyen15: folds
Uncalled bet ($22) returned to Pierson2323
Pierson2323 collected $29.45 from pot
Pierson2323: doesn't show hand
*** SUMMARY ***
Total pot $31 | Rake $1.55
Board [8h 7h 5d Ad]
Seat 1: jimjames32 (big blind) folded before Flop
Seat 2: HHnguyen15 folded on the Turn
Seat 3: 3JackOFF folded before Flop (didn't bet)
Seat 4: kjs609 folded before Flop (didn't bet)
Seat 5: Pierson2323 (button) collected ($29.45)
Seat 6: poppy20633 (small blind) folded before Flop


PokerStars Hand #232991297631:  Hold'em No Limit ($1/$2 USD) - 2022/01/16 10:14:49 ET
Table 'Atalante' 6-max Seat #6 is the button
Seat 1: jimjames32 ($151.24 in chips)
Seat 2: HHnguyen15 ($141.04 in chips)
Seat 3: 3JackOFF ($200 in chips)
Seat 4: kjs609 ($195 in chips)
Seat 5: Pierson2323 ($316.95 in chips)
Seat 6: poppy20633 ($157 in chips)
jimjames32: posts small blind $1
HHnguyen15: posts big blind $2
*** HOLE CARDS ***
3JackOFF: folds
kjs609: folds
Pierson2323: folds
poppy20633: calls $2
jimjames32: calls $1
HHnguyen15: raises $6 to $8
poppy20633: calls $6
jimjames32: raises $143.24 to $151.24 and is all-in
HHnguyen15: calls $133.04 and is all-in
poppy20633: folds
Uncalled bet ($10.20) returned to jimjames32
*** FLOP *** [8d Qd Ts]
*** TURN *** [8d Qd Ts] [Td]
*** RIVER *** [8d Qd Ts Td] [6s]
*** SHOW DOWN ***
jimjames32: shows [As Kc] (a pair of Tens)
HHnguyen15: shows [Ah Kh] (a pair of Tens)
jimjames32 collected $143.54 from pot
HHnguyen15 collected $143.54 from pot
*** SUMMARY ***
Total pot $290.08 | Rake $3
Board [8d Qd Ts Td 6s]
Seat 1: jimjames32 (small blind) showed [As Kc] and won ($143.54) with a pair of Tens
Seat 2: HHnguyen15 (big blind) showed [Ah Kh] and won ($143.54) with a pair of Tens
Seat 3: 3JackOFF folded before Flop (didn't bet)
Seat 4: kjs609 folded before Flop (didn't bet)
Seat 5: Pierson2323 folded before Flop (didn't bet)
Seat 6: poppy20633 (button) folded before Flop


PokerStars Hand #232991297734:  Hold'em No Limit ($1/$2 USD) - 2022/01/16 10:15:17 ET
Table 'Atalante' 6-max Seat #1 is the button
Seat 1: jimjames32 ($153.74 in chips)
Seat 2: HHnguyen15 ($143.54 in chips)
Seat 3: 3JackOFF ($200 in chips)
Seat 4: kjs609 ($195 in chips)
Seat 5: Pierson2323 ($316.95 in chips)
Seat 6: poppy20633 ($149 in chips)
HHnguyen15: posts small blind $1
3JackOFF: posts big blind $2
*** HOLE CARDS ***
kjs609: raises $4 to $6
Pierson2323: folds
poppy20633: folds
jimjames32: calls $6
HHnguyen15: calls $5
3JackOFF: folds
*** FLOP *** [2c Qh 6s]
HHnguyen15: checks
kjs609: bets $9.50
jimjames32: folds
HHnguyen15: folds
Uncalled bet ($9.50) returned to kjs609
kjs609 collected $19 from pot
kjs609: doesn't show hand
*** SUMMARY ***
Total pot $20 | Rake $1
Board [2c Qh 6s]
Seat 1: jimjames32 (button) folded on the Flop
Seat 2: HHnguyen15 (small blind) folded on the Flop
Seat 3: 3JackOFF (big blind) folded before Flop
Seat 4: kjs609 collected ($19)
Seat 5: Pierson2323 folded before Flop (didn't bet)
Seat 6: poppy20633 folded before Flop (didn't bet)


PokerStars Hand #232991297796:  Hold'em No Limit ($1/$2 USD) - 2022/01/16 10:15:37 ET
Table 'Atalante' 6-max Seat #2 is the button
Seat 1: jimjames32 ($147.74 in chips)
Seat 2: HHnguyen15 ($137.54 in chips)
Seat 3: 3JackOFF ($200 in chips)
Seat 4: kjs609 ($208 in chips)
Seat 5: Pierson2323 ($316.95 in chips)
Seat 6: poppy20633 ($149 in chips)
3JackOFF: posts small blind $1
kjs609: posts big blind $2
*** HOLE CARDS ***
Pierson2323: folds
poppy20633: calls $2
jimjames32: calls $2
HHnguyen15: folds
3JackOFF: folds
kjs609: checks
*** FLOP *** [6d 7d 3h]
kjs609: checks
poppy20633: checks
jimjames32: bets $6.65
kjs609: folds
poppy20633: calls $6.65
*** TURN *** [6d 7d 3h] [Jd]
poppy20633: checks
jimjames32: checks
*** RIVER *** [6d 7d 3h Jd] [Qc]
poppy20633: checks
jimjames32: checks
*** SHOW DOWN ***
poppy20633: shows [Ad Tc] (high card Ace)
jimjames32: shows [8h 7s] (a pair of Sevens)
jimjames32 collected $19.28 from pot
*** SUMMARY ***
Total pot $20.30 | Rake $1.02
Board [6d 7d 3h Jd Qc]
Seat 1: jimjames32 showed [8h 7s] and won ($19.28) with a pair of Sevens
Seat 2: HHnguyen15 (button) folded before Flop (didn't bet)
Seat 3: 3JackOFF (small blind) folded before Flop
Seat 4: kjs609 (big blind) folded on the Flop
Seat 5: Pierson2323 folded before Flop (didn't bet)
Seat 6: poppy20633 showed [Ad Tc] and lost with high card Ace


PokerStars Hand #232991297906:  Hold'em No Limit ($1/$2 USD) - 2022/01/16 10:16:07 ET
Table 'Atalante' 6-max Seat #3 is the button
Seat 1: jimjames32 ($158.37 in chips)
Seat 2: HHnguyen15 ($137.54 in chips)
Seat 3: 3JackOFF ($200 in chips)
Seat 4: kjs609 ($206 in chips)
Seat 5: Pierson2323 ($316.95 in chips)
Seat 6: poppy20633 ($140.35 in chips)
kjs609: posts small blind $1
Pierson2323: posts big blind $2
*** HOLE CARDS ***
poppy20633: folds
jimjames32: raises $4 to $6
HHnguyen15: calls $6
3JackOFF: folds
kjs609: folds
Pierson2323: folds
*** FLOP *** [7c 6h 2h]
jimjames32: checks
HHnguyen15: checks
*** TURN *** [7c 6h 2h] [Ac]
jimjames32: checks
HHnguyen15: checks
*** RIVER *** [7c 6h 2h Ac] [Qh]
jimjames32: checks
HHnguyen15: bets $14.25
jimjames32: calls $14.25
*** SHOW DOWN ***
HHnguyen15: shows [3s 5d] (high card Ace)
jimjames32: shows [Qc Kh] (a pair of Queens)
jimjames32 collected $41.32 from pot
*** SUMMARY ***
Total pot $43.50 | Rake $2.18
Board [7c 6h 2h Ac Qh]
Seat 1: jimjames32 showed [Qc Kh] and won ($41.32) with a pair of Queens
Seat 2: HHnguyen15 showed [3s 5d] and lost with high card Ace
Seat 3: 3JackOFF (button) folded before Flop (didn't bet)
Seat 4: kjs609 (small blind) folded before Flop
Seat 5: Pierson2323 (big blind) folded before Flop
Seat 6: poppy20633 folded before Flop (didn't bet)


PokerStars Hand #232991298046:  Hold'em No Limit ($1/$2 USD) - 2022/01/16 10:16:45 ET
Table 'Atalante' 6-max Seat #4 is the button
Seat 1: jimjames32 ($179.44 in chips)
Seat 2: HHnguyen15 ($117.29 in chips)
Seat 3: 3JackOFF ($200 in chips)
Seat 4: kjs609 ($205 in chips)
Seat 5: Pierson2323 ($314.95 in chips)
Seat 6: poppy20633 ($200 in chips)
Pierson2323: posts small blind $1
poppy20633: posts big blind $2
*** HOLE CARDS ***
jimjames32: raises $4 to $6
HHnguyen15: folds
3JackOFF: raises $14 to $20
kjs609: folds
Pierson2323: folds
poppy20633: folds
jimjames32: calls $14
*** FLOP *** [Kd 7c 6d]
jimjames32: checks
3JackOFF: bets $18.28
jimjames32: calls $18.28
*** TURN *** [Kd 7c 6d] [Qs]
jimjames32: checks
3JackOFF: bets $39
jimjames32: raises $102.16 to $141.16 and is all-in
3JackOFF: folds
Uncalled bet ($102.16) returned to jimjames32
jimjames32 collected $154.56 from pot
jimjames32: doesn't show hand
*** SUMMARY ***
Total pot $157.56 | Rake $3
Board [Kd 7c 6d Qs]
Seat 1: jimjames32 collected ($154.56)
Seat 2: HHnguyen15 folded before Flop (didn't bet)
Seat 3: 3JackOFF folded on the Turn
Seat 4: kjs609 (button) folded before Flop (didn't bet)
Seat 5: Pierson2323 (small blind) folded before Flop
Seat 6: poppy20633 (big blind) folded before Flop


PokerStars Hand #232991298237:  Hold'em No Limit ($1/$2 USD) - 2022/01/16 10:17:38 ET
Table 'Atalante' 6-max Seat #5 is the button
Seat 1: jimjames32 ($256.72 in chips)
Seat 2: HHnguyen15 ($117.29 in chips)
Seat 3: 3JackOFF ($200 in chips)
Seat 4: kjs609 ($205 in chips)
Seat 5: Pierson2323 ($313.95 in chips)
Seat 6: poppy20633 ($198 in chips)
poppy20633: posts small blind $1
jimjames32: posts big blind $2
*** HOLE CARDS ***
HHnguyen15: calls $2
3JackOFF: folds
kjs609: folds
Pierson2323: calls $2
poppy20633: calls $1
jimjames32: checks
*** FLOP *** [Jd Qs As]
poppy20633: checks
jimjames32: checks
HHnguyen15: checks
Pierson2323: bets $2
poppy20633: calls $2
jimjames32: calls $2
HHnguyen15: calls $2
*** TURN *** [Jd Qs As] [7c]
poppy20633: checks
jimjames32: checks
HHnguyen15: bets $15.20
Pierson2323: calls $15.20
poppy20633: folds
jimjames32: folds
*** RIVER *** [Jd Qs As 7c] [6c]
HHnguyen15: bets $98.09 and is all-in
Pierson2323: folds
Uncalled bet ($98.09) returned to HHnguyen15
HHnguyen15 collected $44.08 from pot
HHnguyen15: doesn't show hand
*** SUMMARY ***
Total pot $46.40 | Rake $2.32
Board [Jd Qs As 7c 6c]
Seat 1: jimjames32 (big blind) folded on the Turn
Seat 2: HHnguyen15 collected ($44.08)
Seat 3: 3JackOFF folded before Flop (didn't bet)
Seat 4: kjs609 folded before Flop (didn't bet)
Seat 5: Pierson2323 (button) folded on the River
Seat 6: poppy20633 (small blind) folded on the Turn


PokerStars Hand #232991298431:  Hold'em No Limit ($1/$2 USD) - 2022/01/16 10:18:35 ET
Table 'Atalante' 6-max Seat #6 is the button
Seat 1: jimjames32 ($252.72 in chips)
Seat 2: HHnguyen15 ($142.17 in chips)
Seat 3: 3JackOFF ($200 in chips)
Seat 4: kjs609 ($205 in chips)
Seat 5: Pierson2323 ($294.75 in chips)
Seat 6: poppy20633 ($194 in chips)
jimjames32: posts small blind $1
HHnguyen15: posts big blind $2
*** HOLE CARDS ***
3JackOFF: folds
kjs609: folds
Pierson2323: folds
poppy20633: calls $2
jimjames32: calls $1
HHnguyen15: checks
*** FLOP *** [4s 9s Ad]
jimjames32: checks
HHnguyen15: checks
poppy20633: checks
*** TURN *** [4s 9s Ad] [Kd]
jimjames32: bets $2
HHnguyen15: calls $2
poppy20633: folds
*** RIVER *** [4s 9s Ad Kd] [Ah]
jimjames32: bets $2
HHnguyen15: calls $2
*** SHOW DOWN ***
jimjames32: shows [2h As] (three of a kind, Aces)
HHnguyen15: mucks hand
jimjames32 collected $13.30 from pot
*** SUMMARY ***
Total pot $14 | Rake $0.70
Board [4s 9s Ad Kd Ah]
Seat 1: jimjames32 (small blind) showed [2h As] and won ($13.30) with three of a kind, Aces
Seat 2: HHnguyen15 (big blind) mucked
Seat 3: 3JackOFF folded before Flop (didn't bet)
Seat 4: kjs609 folded before Flop (didn't bet)
Seat 5: Pierson2323 folded before Flop (didn't bet)
Seat 6: poppy20633 (button) folded on the Turn


PokerStars Hand #232991298532:  Hold'em No Limit ($1/$2 USD) - 2022/01/16 10:19:03 ET
Table 'Atalante' 6-max Seat #1 is the button
Seat 1: jimjames32 ($260.02 in chips)
Seat 2: HHnguyen15 ($136.17 in chips)
Seat 3: 3JackOFF ($200 in chips)
Seat 4: kjs609 ($205 in chips)
Seat 5: Pierson2323 ($294.75 in chips)
Seat 6: poppy20633 ($192 in chips)
HHnguyen15: posts small blind $1
3JackOFF: posts big blind $2
*** HOLE CARDS ***
kjs609: folds
Pierson2323: folds
poppy20633: folds
jimjames32: folds
HHnguyen15: folds
Uncalled bet ($1) returned to 3JackOFF
3JackOFF collected $2 from pot
3JackOFF: doesn't show hand
*** SUMMARY ***
Total pot $2 | Rake $0
Seat 1: jimjames32 (button) folded before Flop (didn't bet)
Seat 2: HHnguyen15 (small blind) folded before Flop
Seat 3: 3JackOFF (big blind) collected ($2)
Seat 4: kjs609 folded before Flop (didn't bet)
Seat 5: Pierson2323 folded before Flop (didn't bet)
Seat 6: poppy20633 folded before Flop (didn't bet)


PokerStars Hand #232991298579:  Hold'em No Limit ($1/$2 USD) - 2022/01/16 10:19:14 ET
Table 'Atalante' 6-max Seat #2 is the button
Seat 1: jimjames32 ($260.02 in chips)
Seat 2: HHnguyen15 ($135.17 in chips)
Seat 3: 3JackOFF ($201 in chips)
Seat 4: kjs609 ($205 in chips)
Seat 5: Pierson2323 ($294.75 in chips)
Seat 6: poppy20633 ($192 in chips)
3JackOFF: posts small blind $1
kjs609: posts big blind $2
*** HOLE CARDS ***
Pierson2323: folds
poppy20633: folds
jimjames32: folds
HHnguyen15: calls $2
3JackOFF: folds
kjs609: checks
*** FLOP *** [2s Th 8s]
kjs609: checks
HHnguyen15: bets $4.75
kjs609: calls $4.75
*** TURN *** [2s Th 8s] [3c]
kjs609: checks
HHnguyen15: checks
*** RIVER *** [2s Th 8s 3c] [2h]
kjs609: bets $13.78
HHnguyen15: calls $13.78
*** SHOW DOWN ***
kjs609: shows [Qd Js] (a pair of Deuces)
HHnguyen15: shows [9d 8d] (two pair, Eights and Deuces)
HHnguyen15 collected $39.96 from pot
*** SUMMARY ***
Total pot $42.06 | Rake $2.10
Board [2s Th 8s 3c 2h]
Seat 1: jimjames32 folded before Flop (didn't bet)
Seat 2: HHnguyen15 (button) showed [9d 8d] and won ($39.96) with two pair, Eights and Deuces
Seat 3: 3JackOFF (small blind) folded before Flop
Seat 4: kjs609 (big blind) showed [Qd Js] and lost with a pair of Deuces
Seat 5: Pierson2323 folded before Flop (didn't bet)
Seat 6: poppy20633 folded before Flop (didn't bet)


PokerStars Hand #232991298729:  Hold'em No Limit ($1/$2 USD) - 2022/01/16 10:19:51 ET
Table 'Atalante' 6-max Seat #3 is the button
Seat 1: jimjames32 ($260.02 in chips)
Seat 2: HHnguyen15 ($154.60 in chips)
Seat 3: 3JackOFF ($200 in chips)
Seat 4: kjs609 ($184.47 in chips)
Seat 5: Pierson2323 ($294.75 in chips)
Seat 6: poppy20633 ($192 in chips)
kjs609: posts small blind $1
Pierson2323: posts big blind $2
*** HOLE CARDS ***
poppy20633: calls $2
jimjames32: calls $2
HHnguyen15: calls $2
3JackOFF: folds
kjs609: raises $6 to $8
Pierson2323: folds
poppy20633: calls $6
jimjames32: calls $6
HHnguyen15: calls $6
*** FLOP *** [2s 8d 4s]
kjs609: bets $16.15
poppy20633: folds
jimjames32: calls $16.15
HHnguyen15: folds
*** TURN *** [2s 8d 4s] [Jd]
kjs609: checks
jimjames32: checks
*** RIVER *** [2s 8d 4s Jd] [Tc]
kjs609: checks
jimjames32: checks
*** SHOW DOWN ***
kjs609: shows [Kh Ac] (high card Ace)
jimjames32: shows [5d 4h] (a pair of Fours)
jimjames32 collected $63.30 from pot
*** SUMMARY ***
Total pot $66.30 | Rake $3
Board [2s 8d 4s Jd Tc]
Seat 1: jimjames32 showed [5d 4h] and won ($63.30) with a pair of Fours
Seat 2: HHnguyen15 folded on the Flop
Seat 3: 3JackOFF (button) folded before Flop (didn't bet)
Seat 4: kjs609 (small blind) showed [Kh Ac] and lost with high card Ace
Seat 5: Pierson2323 (big blind) folded before Flop
Seat 6: poppy20633 folded on the Flop


PokerStars Hand #232991298902:  Hold'em No Limit ($1/$2 USD) - 2022/01/16 10:20:30 ET
Table 'Atalante' 6-max Seat #4 is the button
Seat 1: jimjames32 ($299.17 in chips)
Seat 2: HHnguyen15 ($146.60 in chips)
Seat 3: 3JackOFF ($200 in chips)
Seat 4: kjs609 ($160.32 in chips)
Seat 5: Pierson2323 ($292.75 in chips)
Seat 6: poppy20633 ($184 in chips)
Pierson2323: posts small blind $1
poppy20633: posts big blind $2
*** HOLE CARDS ***
jimjames32: folds
HHnguyen15: folds
3JackOFF: raises $3 to $5
kjs609: folds
Pierson2323: folds
poppy20633: calls $3
*** FLOP *** [Kc 5d 9s]
poppy20633: checks
3JackOFF: checks
*** TURN *** [Kc 5d 9s] [Ks]
poppy20633: checks
3JackOFF: checks
*** RIVER *** [Kc 5d 9s Ks] [3d]
poppy20633: checks
3JackOFF: checks
*** SHOW DOWN ***
poppy20633: shows [4c Ah] (a pair of Kings)
3JackOFF: mucks hand
poppy20633 collected $10.45 from pot
*** SUMMARY ***
Total pot $11 | Rake $0.55
Board [Kc 5d 9s Ks 3d]
Seat 1: jimjames32 folded before Flop (didn't bet)
Seat 2: HHnguyen15 folded before Flop (didn't bet)
Seat 3: 3JackOFF mucked
Seat 4: kjs609 (button) folded before Flop (didn't bet)
Seat 5: Pierson2323 (small blind) folded before Flop
Seat 6: poppy20633 (big blind) showed [4c Ah] and won ($10.45) with a pair of Kings


PokerStars Hand #232991299035:  Hold'em No Limit ($1/$2 USD) - 2022/01/16 10:21:02 ET
Table 'Atalante' 6-max Seat #5 is the button
Seat 1: jimjames32 ($299.17 in chips)
Seat 2: HHnguyen15 ($146.60 in chips)
Seat 3: 3JackOFF ($200 in chips)
Seat 4: kjs609 ($200 in chips)
Seat 5: Pierson2323 ($291.75 in chips)
Seat 6: poppy20633 ($189.45 in chips)
poppy20633: posts small blind $1
jimjames32: posts big blind $2
*** HOLE CARDS ***
HHnguyen15: calls $2
3JackOFF: folds
kjs609: folds
Pierson2323: folds
poppy20633: folds
jimjames32: raises $2 to $4
HHnguyen15: calls $2
*** FLOP *** [2d 8c 6d]
jimjames32: checks
HHnguyen15: bets $8.55
jimjames32: calls $8.55
*** TURN *** [2d 8c 6d] [2c]
jimjames32: checks
HHnguyen15: checks
*** RIVER *** [2d 8c 6d 2c] [5h]
jimjames32: checks
HHnguyen15: checks
*** SHOW DOWN ***
jimjames32: shows [Ac 3c] (a pair of Deuces)
HHnguyen15: shows [Qs 8s] (two pair, Eights and Deuces)
HHnguyen15 collected $24.80 from pot
*** SUMMARY ***
Total pot $26.10 | Rake $1.30
Board [2d 8c 6d 2c 5h]
Seat 1: jimjames32 (big blind) showed [Ac 3c] and lost with a pair of Deuces
Seat 2: HHnguyen15 showed [Qs 8s] and won ($24.80) with two pair, Eights and Deuces
Seat 3: 3JackOFF folded before Flop (didn't bet)
Seat 4: kjs609 folded before Flop (didn't bet)
Seat 5: Pierson2323 (button) folded before Flop (didn't bet)
Seat 6: poppy20633 (small blind) folded before Flop


PokerStars Hand #232991299116:  Hold'em No Limit ($1/$2 USD) - 2022/01/16 10:21:23 ET
Table 'Atalante' 6-max Seat #6 is the button
Seat 1: jimjames32 ($286.62 in chips)
Seat 2: HHnguyen15 ($158.85 in chips)
Seat 3: 3JackOFF ($200 in chips)
Seat 4: kjs609 ($200 in chips)
Seat 5: Pierson2323 ($291.75 in chips)
Seat 6: poppy20633 ($188.45 in chips)
jimjames32: posts small blind $1
HHnguyen15: posts big blind $2
*** HOLE CARDS ***
3JackOFF: raises $3 to $5
kjs609: folds
Pierson2323: folds
poppy20633: folds
jimjames32: calls $4
HHnguyen15: calls $3
*** FLOP *** [3s As 7d]
jimjames32: checks
HHnguyen15: checks
3JackOFF: bets $6.24
jimjames32: calls $6.24
HHnguyen15: folds
*** TURN *** [3s As 7d] [7c]
jimjames32: checks
3JackOFF: checks
*** RIVER *** [3s As 7d 7c] [8c]
jimjames32: checks
3JackOFF: bets $37.60
jimjames32: folds
Uncalled bet ($37.60) returned to 3JackOFF
3JackOFF collected $26.11 from pot
3JackOFF: doesn't show hand
*** SUMMARY ***
Total pot $27.48 | Rake $1.37
Board [3s As 7d 7c 8c]
Seat 1: jimjames32 (small blind) folded on the River
Seat 2: HHnguyen15 (big blind) folded on the Flop
Seat 3: 3JackOFF collected ($26.11)
Seat 4: kjs609 folded before Flop (didn't bet)
Seat 5: Pierson2323 folded before Flop (didn't bet)
Seat 6: poppy20633 (button) folded before Flop (didn't bet)


PokerStars Hand #232991299257:  Hold'em No Limit ($1/$2 USD) - 2022/01/16 10:22:00 ET
Table 'Atalante' 6-max Seat #1 is the button
Seat 1: jimjames32 ($275.38 in chips)
Seat 2: HHnguyen15 ($153.85 in chips)
Seat 3: 3JackOFF ($214.87 in chips)
Seat 4: kjs609 ($200 in chips)
Seat 5: Pierson2323 ($291.75 in chips)
Seat 6: poppy20633 ($188.45 in chips)
HHnguyen15: posts small blind $1
3JackOFF: posts big blind $2
*** HOLE CARDS ***
kjs609: folds
Pierson2323: raises $4 to $6
poppy20633: folds
jimjames32: folds
HHnguyen15: folds
3JackOFF: folds
Uncalled bet ($4) returned to Pierson2323
Pierson2323 collected $5 from pot
Pierson2323: doesn't show hand
*** SUMMARY ***
Total pot $5 | Rake $0
Seat 1: jimjames32 (button) folded before Flop (didn't bet)
Seat 2: HHnguyen15 (small blind) folded before Flop
Seat 3: 3JackOFF (big blind) folded before Flop
Seat 4: kjs609 folded before Flop (didn't bet)
Seat 5: Pierson2323 collected ($5)
Seat 6: poppy20633 folded before Flop (didn't bet)


PokerStars Hand #232991299325:  Hold'em No Limit ($1/$2 USD) - 2022/01/16 10:22:17 ET
Table 'Atalante' 6-max Seat #2 is the button
Seat 1: jimjames32 ($275.38 in chips)
Seat 2: HHnguyen15 ($152.85 in chips)
Seat 3: 3JackOFF ($212.87 in chips)
Seat 4: kjs609 ($200 in chips)
Seat 5: Pierson2323 ($294.75 in chips)
Seat 6: poppy20633 ($188.45 in chips)
3JackOFF: posts small blind $1
kjs609: posts big blind $2
*** HOLE CARDS ***
Pierson2323: folds
poppy20633: folds
jimjames32: folds
HHnguyen15: folds
3JackOFF: folds
Uncalled bet ($1) returned to kjs609
kjs609 collected $2 from pot
kjs609: doesn't show hand
*** SUMMARY ***
Total pot $2 | Rake $0
Seat 1: jimjames32 folded before Flop (didn't bet)
Seat 2: HHnguyen15 (button) folded before Flop (didn't bet)
Seat 3: 3JackOFF (small blind) folded before Flop
Seat 4: kjs609 (big blind) collected ($2)
Seat 5: Pierson2323 folded before Flop (didn't bet)
Seat 6: poppy20633 folded before Flop (didn't bet)


PokerStars Hand #232991299349:  Hold'em No Limit ($1/$2 USD) - 2022/01/16 10:22:24 ET
Table 'Atalante' 6-max Seat #3 is the button
Seat 1: jimjames32 ($275.38 in chips)
Seat 2: HHnguyen15 ($152.85 in chips)
Seat 3: 3JackOFF ($211.87 in chips)
Seat 4: kjs609 ($201 in chips)
Seat 5: Pierson2323 ($294.75 in chips)
Seat 6: poppy20633 ($188.45 in chips)
kjs609: posts small blind $1
Pierson2323: posts big blind $2
*** HOLE CARDS ***
poppy20633: folds
jimjames32: folds
HHnguyen15: folds
3JackOFF: folds
kjs609: folds
Uncalled bet ($1) returned to Pierson2323
Pierson2323 collected $2 from pot
*** SUMMARY ***
Total pot $2 | Rake $0
Seat 1: jimjames32 folded before Flop (didn't bet)
Seat 2: HHnguyen15 folded before Flop (didn't bet)
Seat 3: 3JackOFF (button) folded before Flop (didn't bet)
Seat 4: kjs609 (small blind) folded before Flop
Seat 5: Pierson2323 (big blind) collected ($2)
Seat 6: poppy20633 folded before Flop (didn't bet)


PokerStars Hand #232991299384:  Hold'em No Limit ($1/$2 USD) - 2022/01/16 10:22:35 ET
Table 'Atalante' 6-max Seat #4 is the button
Seat 1: jimjames32 ($275.38 in chips)
Seat 2: HHnguyen15 ($152.85 in chips)
Seat 3: 3JackOFF ($211.87 in chips)
Seat 4: kjs609 ($200 in chips)
Seat 5: Pierson2323 ($295.75 in chips)
Seat 6: poppy20633 ($188.45 in chips)
Pierson2323: posts small blind $1
poppy20633: posts big blind $2
*** HOLE CARDS ***
jimjames32: raises $4 to $6
HHnguyen15: calls $6
3JackOFF: folds
kjs609: folds
Pierson2323: calls $5
poppy20633: folds
*** FLOP *** [2c 9c Qs]
Pierson2323: checks
jimjames32: checks
HHnguyen15: checks
*** TURN *** [2c 9c Qs] [6h]
Pierson2323: checks
jimjames32: checks
HHnguyen15: checks
*** RIVER *** [2c 9c Qs 6h] [Jc]
Pierson2323: checks
jimjames32: checks
HHnguyen15: bets $19
Pierson2323: folds
jimjames32: calls $19
*** SHOW DOWN ***
HHnguyen15: shows [Th Kd] (a straight, Nine to King)
jimjames32: mucks hand
HHnguyen15 collected $55.10 from pot
*** SUMMARY ***
Total pot $58 | Rake $2.90
Board [2c 9c Qs 6h Jc]
Seat 1: jimjames32 mucked
Seat 2: HHnguyen15 showed [Th Kd] and won ($55.10) with a straight, Nine to King
Seat 3: 3JackOFF folded before Flop (didn't bet)
Seat 4: kjs609 (button) folded before Flop (didn't bet)
Seat 5: Pierson2323 (small blind) folded on the River
Seat 6: poppy20633 (big blind) folded before Flop


PokerStars Hand #232991299543:  Hold'em No Limit ($1/$2 USD) - 2022/01/16 10:23:17 ET
Table 'Atalante' 6-max Seat #5 is the button
Seat 1: jimjames32 ($250.38 in chips)
Seat 2: HHnguyen15 ($182.95 in chips)
Seat 3: 3JackOFF ($211.87 in chips)
Seat 4: kjs609 ($200 in chips)
Seat 5: Pierson2323 ($289.75 in chips)
Seat 6: poppy20633 ($186.45 in chips)
poppy20633: posts small blind $1
jimjames32: posts big blind $2
*** HOLE CARDS ***
HHnguyen15: folds
3JackOFF: folds
kjs609: folds
Pierson2323: raises $4 to $6
poppy20633: folds
jimjames32: calls $4
*** FLOP *** [7c 5s Tc]
jimjames32: checks
Pierson2323: checks
*** TURN *** [7c 5s Tc] [Qs]
jimjames32: checks
Pierson2323: bets $8
jimjames32: calls $8
*** RIVER *** [7c 5s Tc Qs] [9s]
jimjames32: checks
Pierson2323: checks
*** SHOW DOWN ***
jimjames32: shows [6d Ts] (a pair of Tens)
Pierson2323: mucks hand
jimjames32 collected $27.55 from pot
*** SUMMARY ***
Total pot $29 | Rake $1.45
Board [7c 5s Tc Qs 9s]
Seat 1: jimjames32 (big blind) showed [6d Ts] and won ($27.55) with a pair of Tens
Seat 2: HHnguyen15 folded before Flop (didn't bet)
Seat 3: 3JackOFF folded before Flop (didn't bet)
Seat 4: kjs609 folded before Flop (didn't bet)
Seat 5: Pierson2323 (button) mucked
Seat 6: poppy20633 (small blind) folded before Flop


PokerStars Hand #232991299662:  Hold'em No Limit ($1/$2 USD) - 2022/01/16 10:23:48 ET
Table 'Atalante' 6-max Seat #6 is the button
Seat 1: jimjames32 ($263.93 in chips)
Seat 2: HHnguyen15 ($182.95 in chips)
Seat 3: 3JackOFF ($211.87 in chips)
Seat 4: kjs609 ($200 in chips)
Seat 5: Pierson2323 ($275.75 in chips)
Seat 6: poppy20633 ($185.45 in chips)
jimjames32: posts small blind $1
HHnguyen15: posts big blind $2
*** HOLE CARDS ***
3JackOFF: raises $3 to $5
kjs609: folds
Pierson2323: folds
poppy20633: folds
jimjames32: folds
HHnguyen15: calls $3
*** FLOP *** [Ks Qs 6s]
HHnguyen15: checks
3JackOFF: checks
*** TURN *** [Ks Qs 6s] [3s]
HHnguyen15: checks
3JackOFF: bets $3.34
HHnguyen15: folds
Uncalled bet ($3.34) returned to 3JackOFF
3JackOFF collected $10.45 from pot
3JackOFF: doesn't show hand
*** SUMMARY ***
Total pot $11 | Rake $0.55
Board [Ks Qs 6s 3s]
Seat 1: jimjames32 (small blind) folded before Flop
Seat 2: HHnguyen15 (big blind) folded on the Turn
Seat 3: 3JackOFF collected ($10.45)
Seat 4: kjs609 folded before Flop (didn't bet)
Seat 5: Pierson2323 folded before Flop (didn't bet)
Seat 6: poppy20633 (button) folded before Flop (didn't bet)


PokerStars Hand #232991299754:  Hold'em No Limit ($1/$2 USD) - 2022/01/16 10:24:11 ET
Table 'Atalante' 6-max Seat #1 is the button
Seat 1: jimjames32 ($262.93 in chips)
Seat 2: HHnguyen15 ($177.95 in chips)
Seat 3: 3JackOFF ($217.32 in chips)
Seat 4: kjs609 ($200 in chips)
Seat 5: Pierson2323 ($275.75 in chips)
Seat 6: poppy20633 ($185.45 in chips)
HHnguyen15: posts small blind $1
3JackOFF: posts big blind $2
*** HOLE CARDS ***
kjs609: folds
Pierson2323: folds
poppy20633: folds
jimjames32: raises $4 to $6
HHnguyen15: folds
3JackOFF: folds
Uncalled bet ($4) returned to jimjames32
jimjames32 collected $5 from pot
jimjames32: doesn't show hand
*** SUMMARY ***
Total pot $5 | Rake $0
Seat 1: jimjames32 (button) collected ($5)
Seat 2: HHnguyen15 (small blind) folded before Flop
Seat 3: 3JackOFF (big blind) folded before Flop
Seat 4: kjs609 folded before Flop (didn't bet)
Seat 5: Pierson2323 folded before Flop (didn't bet)
Seat 6: poppy20633 folded before Flop (didn't bet)


PokerStars Hand #232991299796:  Hold'em No Limit ($1/$2 USD) - 2022/01/16 10:24:22 ET
Table 'Atalante' 6-max Seat #2 is the button
Seat 1: jimjames32 ($265.93 in chips)
Seat 2: HHnguyen15 ($176.95 in chips)
Seat 3: 3JackOFF ($215.32 in chips)
Seat 4: kjs609 ($200 in chips)
Seat 5: Pierson2323 ($275.75 in chips)
Seat 6: poppy20633 ($185.45 in chips)
3JackOFF: posts small blind $1
kjs609: posts big blind $2
*** HOLE CARDS ***
Pierson2323: raises $4 to $6
poppy20633: folds
jimjames32: folds
HHnguyen15: folds
3JackOFF: folds
kjs609: folds
Uncalled bet ($4) returned to Pierson2323
Pierson2323 collected $5 from pot
*** SUMMARY ***
Total pot $5 | Rake $0
Seat 1: jimjames32 folded before Flop (didn't bet)
Seat 2: HHnguyen15 (button) folded before Flop (didn't bet)
Seat 3: 3JackOFF (small blind) folded before Flop
Seat 4: kjs609 (big blind) folded before Flop
Seat 5: Pierson2323 collected ($5)
Seat 6: poppy20633 folded before Flop (didn't bet)


PokerStars Hand #232991299829:  Hold'em No Limit ($1/$2 USD) - 2022/01/16 10:24:31 ET
Table 'Atalante' 6-max Seat #3 is the button
Seat 1: jimjames32 ($265.93 in chips)
Seat 2: HHnguyen15 ($176.95 in chips)
Seat 3: 3JackOFF ($214.32 in chips)
Seat 4: kjs609 ($198 in chips)
Seat 5: Pierson2323 ($278.75 in chips)
Seat 6: poppy20633 ($185.45 in chips)
kjs609: posts small blind $1
Pierson2323: posts big blind $2
*** HOLE CARDS ***
poppy20633: folds
jimjames32: raises $4 to $6
HHnguyen15: folds
3JackOFF: folds
kjs609: folds
Pierson2323: folds
Uncalled bet ($4) returned to jimjames32
jimjames32 collected $5 from pot
jimjames32: doesn't show hand
*** SUMMARY ***
Total pot $5 | Rake $0
Seat 1: jimjames32 collected ($5)
Seat 2: HHnguyen15 folded before Flop (didn't bet)
Seat 3: 3JackOFF (button) folded before Flop (didn't bet)
Seat 4: kjs609 (small blind) folded before Flop
Seat 5: Pierson2323 (big blind) folded before Flop
Seat 6: poppy20633 folded before Flop (didn't bet)


PokerStars Hand #232991299921:  Hold'em No Limit ($1/$2 USD) - 2022/01/16 10:24:54 ET
Table 'Atalante' 6-max Seat #4 is the button
Seat 1: jimjames32 ($268.93 in chips)
Seat 2: HHnguyen15 ($176.95 in chips)
Seat 3: 3JackOFF ($214.32 in chips)
Seat 4: kjs609 ($197 in chips)
Seat 5: Pierson2323 ($276.75 in chips)
Seat 6: poppy20633 ($185.45 in chips)
Pierson2323: posts small blind $1
poppy20633: posts big blind $2
*** HOLE CARDS ***
jimjames32: raises $4 to $6
HHnguyen15: folds
3JackOFF: folds
kjs609: folds
Pierson2323: folds
poppy20633: folds
Uncalled bet ($4) returned to jimjames32
jimjames32 collected $5 from pot
jimjames32: doesn't show hand
*** SUMMARY ***
Total pot $5 | Rake $0
Seat 1: jimjames32 collected ($5)
Seat 2: HHnguyen15 folded before Flop (didn't bet)
Seat 3: 3JackOFF folded before Flop (didn't bet)
Seat 4: kjs609 (button) folded before Flop (didn't bet)
Seat 5: Pierson2323 (small blind) folded before Flop
Seat 6: poppy20633 (big blind) folded before Flop


PokerStars Hand #232991299963:  Hold'em No Limit ($1/$2 USD) - 2022/01/16 10:25:06 ET
Table 'Atalante' 6-max Seat #5 is the button
Seat 1: jimjames32 ($271.93 in chips)
Seat 2: HHnguyen15 ($176.95 in chips)
Seat 3: 3JackOFF ($214.32 in chips)
Seat 4: kjs609 ($197 in chips)
Seat 5: Pierson2323 ($275.75 in chips)
Seat 6: poppy20633 ($183.45 in chips)
poppy20633: posts small blind $1
jimjames32: posts big blind $2
*** HOLE CARDS ***
HHnguyen15: calls $2
3JackOFF: folds
kjs609: folds
Pierson2323: raises $8 to $10
poppy20633: calls $9
jimjames32: calls $8
HHnguyen15: calls $8
*** FLOP *** [9c 4c 5d]
poppy20633: checks
jimjames32: checks
HHnguyen15: checks
Pierson2323: bets $24
poppy20633: calls $24
jimjames32: folds
HHnguyen15: folds
*** TURN *** [9c 4c 5d] [Jd]
poppy20633: checks
Pierson2323: checks
*** RIVER *** [9c 4c 5d Jd] [2s]
poppy20633: checks
Pierson2323: bets $30
poppy20633: calls $30
*** SHOW DOWN ***
Pierson2323: shows [Js Qd] (a pair of Jacks)
poppy20633: mucks hand
Pierson2323 collected $145 from pot
*** SUMMARY ***
Total pot $148 | Rake $3
Board [9c 4c 5d Jd 2s]
Seat 1: jimjames32 (big blind) folded on the Flop
Seat 2: HHnguyen15 folded on the Flop
Seat 3: 3JackOFF folded before Flop (didn't bet)
Seat 4: kjs609 folded before Flop (didn't bet)
Seat 5: Pierson2323 (button) showed [Js Qd] and won ($145) with a pair of Jacks
Seat 6: poppy20633 (small blind) mucked


PokerStars Hand #232991554735:  Hold'em No Limit ($1/$2 USD) - 2022/01/16 10:25:46 ET
Table 'Atalante' 6-max Seat #6 is the button
Seat 1: jimjames32 ($261.93 in chips)
Seat 2: HHnguyen15 ($166.95 in chips)
Seat 3: 3JackOFF ($214.32 in chips)
Seat 4: kjs609 ($197 in chips)
Seat 5: Pierson2323 ($356.75 in chips)
Seat 6: poppy20633 ($119.45 in chips)
jimjames32: posts small blind $1
HHnguyen15: posts big blind $2
*** HOLE CARDS ***
3JackOFF: folds
kjs609: folds
Pierson2323: folds
poppy20633: calls $2
jimjames32: folds
HHnguyen15: checks
*** FLOP *** [6d 4h 6s]
HHnguyen15: checks
poppy20633: checks
*** TURN *** [6d 4h 6s] [8s]
HHnguyen15: checks
poppy20633: bets $4.75
HHnguyen15: calls $4.75
*** RIVER *** [6d 4h 6s 8s] [Ad]
HHnguyen15: checks
poppy20633: checks
*** SHOW DOWN ***
HHnguyen15: shows [Th 8h] (two pair, Eights and Sixes)
poppy20633: mucks hand
HHnguyen15 collected $13.78 from pot
*** SUMMARY ***
Total pot $14.50 | Rake $0.72
Board [6d 4h 6s 8s Ad]
Seat 1: jimjames32 (small blind) folded before Flop
Seat 2: HHnguyen15 (big blind) showed [Th 8h] and won ($13.78) with two pair, Eights and Sixes
Seat 3: 3JackOFF folded before Flop (didn't bet)
Seat 4: kjs609 folded before Flop (didn't bet)
Seat 5: Pierson2323 folded before Flop (didn't bet)
Seat 6: poppy20633 (button) mucked


PokerStars Hand #232991554841:  Hold'em No Limit ($1/$2 USD) - 2022/01/16 10:26:09 ET
Table 'Atalante' 6-max Seat #1 is the button
Seat 1: jimjames32 ($260.93 in chips)
Seat 2: HHnguyen15 ($173.98 in chips)
Seat 3: 3JackOFF ($214.32 in chips)
Seat 4: kjs609 ($197 in chips)
Seat 5: Pierson2323 ($356.75 in chips)
Seat 6: poppy20633 ($193.25 in chips)
HHnguyen15: posts small blind $1
3JackOFF: posts big blind $2
*** HOLE CARDS ***
kjs609: folds
Pierson2323: raises $4 to $6
poppy20633: folds
jimjames32: calls $6
HHnguyen15: folds
3JackOFF: raises $26 to $32
Pierson2323: folds
jimjames32: folds
Uncalled bet ($26) returned to 3JackOFF
3JackOFF collected $19 from pot
3JackOFF: doesn't show hand
*** SUMMARY ***
Total pot $19 | Rake $0
Seat 1: jimjames32 (button) folded before Flop
Seat 2: HHnguyen15 (small blind) folded before Flop
Seat 3: 3JackOFF (big blind) collected ($19)
Seat 4: kjs609 folded before Flop (didn't bet)
Seat 5: Pierson2323 folded before Flop
Seat 6: poppy20633 folded before Flop (didn't bet)


PokerStars Hand #232991554922:  Hold'em No Limit ($1/$2 USD) - 2022/01/16 10:26:30 ET
Table 'Atalante' 6-max Seat #2 is the button
Seat 1: jimjames32 ($254.93 in chips)
Seat 2: HHnguyen15 ($172.98 in chips)
Seat 3: 3JackOFF ($227.32 in chips)
Seat 4: kjs609 ($197 in chips)
Seat 5: Pierson2323 ($350.75 in chips)
Seat 6: poppy20633 ($193.25 in chips)
3JackOFF: posts small blind $1
kjs609: posts big blind $2
*** HOLE CARDS ***
Pierson2323: raises $4 to $6
poppy20633: calls $6
jimjames32: calls $6
HHnguyen15: folds
3JackOFF: folds
kjs609: calls $4
*** FLOP *** [7h 8s 6s]
kjs609: checks
Pierson2323: checks
poppy20633: checks
jimjames32: checks
*** TURN *** [7h 8s 6s] [Ad]
kjs609: checks
Pierson2323: checks
poppy20633: bets $11.87
jimjames32: calls $11.87
kjs609: folds
Pierson2323: folds
*** RIVER *** [7h 8s 6s Ad] [Ts]
poppy20633: checks
jimjames32: bets $46.30
poppy20633: folds
Uncalled bet ($46.30) returned to jimjames32
jimjames32 collected $46.30 from pot
jimjames32: doesn't show hand
*** SUMMARY ***
Total pot $48.74 | Rake $2.44
Board [7h 8s 6s Ad Ts]
Seat 1: jimjames32 collected ($46.30)
Seat 2: HHnguyen15 (button) folded before Flop (didn't bet)
Seat 3: 3JackOFF (small blind) folded before Flop
Seat 4: kjs609 (big blind) folded on the Turn
Seat 5: Pierson2323 folded on the Turn
Seat 6: poppy20633 folded on the River


PokerStars Hand #232991555159:  Hold'em No Limit ($1/$2 USD) - 2022/01/16 10:27:24 ET
Table 'Atalante' 6-max Seat #3 is the button
Seat 1: jimjames32 ($283.36 in chips)
Seat 2: HHnguyen15 ($172.98 in chips)
Seat 3: 3JackOFF ($226.32 in chips)
Seat 4: kjs609 ($191 in chips)
Seat 5: Pierson2323 ($344.75 in chips)
Seat 6: poppy20633 ($175.38 in chips)
kjs609: posts small blind $1
Pierson2323: posts big blind $2
*** HOLE CARDS ***
poppy20633: calls $2
jimjames32: raises $4 to $6
HHnguyen15: folds
3JackOFF: folds
kjs609: folds
Pierson2323: calls $4
poppy20633: raises $21 to $27
jimjames32: folds
Pierson2323: folds
Uncalled bet ($21) returned to poppy20633
poppy20633 collected $19 from pot
poppy20633: doesn't show hand
*** SUMMARY ***
Total pot $19 | Rake $0
Seat 1: jimjames32 folded before Flop
Seat 2: HHnguyen15 folded before Flop (didn't bet)
Seat 3: 3JackOFF (button) folded before Flop (didn't bet)
Seat 4: kjs609 (small blind) folded before Flop
Seat 5: Pierson2323 (big blind) folded before Flop
Seat 6: poppy20633 collected ($19)


PokerStars Hand #232991555238:  Hold'em No Limit ($1/$2 USD) - 2022/01/16 10:27:43 ET
Table 'Atalante' 6-max Seat #4 is the button
Seat 1: jimjames32 ($277.36 in chips)
Seat 2: HHnguyen15 ($172.98 in chips)
Seat 3: 3JackOFF ($226.32 in chips)
Seat 4: kjs609 ($190 in chips)
Seat 5: Pierson2323 ($338.75 in chips)
Seat 6: poppy20633 ($188.38 in chips)
Pierson2323: posts small blind $1
poppy20633: posts big blind $2
*** HOLE CARDS ***
jimjames32: raises $4 to $6
HHnguyen15: calls $6
3JackOFF: folds
kjs609: folds
Pierson2323: folds
poppy20633: folds
*** FLOP *** [8c Ts 6s]
jimjames32: bets $7.12
HHnguyen15: calls $7.12
*** TURN *** [8c Ts 6s] [2h]
jimjames32: checks
HHnguyen15: checks
*** RIVER *** [8c Ts 6s 2h] [7c]
jimjames32: checks
HHnguyen15: checks
*** SHOW DOWN ***
jimjames32: shows [Js Tc] (a pair of Tens)
HHnguyen15: mucks hand
jimjames32 collected $27.78 from pot
*** SUMMARY ***
Total pot $29.24 | Rake $1.46
Board [8c Ts 6s 2h 7c]
Seat 1: jimjames32 showed [Js Tc] and won ($27.78) with a pair of Tens
Seat 2: HHnguyen15 mucked
Seat 3: 3JackOFF folded before Flop (didn't bet)
Seat 4: kjs609 (button) folded before Flop (didn't bet)
Seat 5: Pierson2323 (small blind) folded before Flop
Seat 6: poppy20633 (big blind) folded before Flop


PokerStars Hand #232991555348:  Hold'em No Limit ($1/$2 USD) - 2022/01/16 10:28:03 ET
Table 'Atalante' 6-max Seat #5 is the button
Seat 1: jimjames32 ($292.02 in chips)
Seat 2: HHnguyen15 ($159.86 in chips)
Seat 3: 3JackOFF ($226.32 in chips)
Seat 4: kjs609 ($190 in chips)
Seat 5: Pierson2323 ($337.75 in chips)
Seat 6: poppy20633 ($186.38 in chips)
poppy20633: posts small blind $1
jimjames32: posts big blind $2
*** HOLE CARDS ***
HHnguyen15: folds
3JackOFF: raises $3 to $5
kjs609: folds
Pierson2323: folds
poppy20633: calls $4
jimjames32: calls $3
*** FLOP *** [2c 6h 7d]
poppy20633: checks
jimjames32: checks
3JackOFF: checks
*** TURN *** [2c 6h 7d] [5c]
poppy20633: checks
jimjames32: checks
3JackOFF: checks
*** RIVER *** [2c 6h 7d 5c] [8s]
poppy20633: checks
jimjames32: checks
3JackOFF: bets $4.56
poppy20633: folds
jimjames32: calls $4.56
*** SHOW DOWN ***
3JackOFF: shows [9d Ah] (a straight, Five to Nine)
jimjames32: mucks hand
3JackOFF collected $22.91 from pot
*** SUMMARY ***
Total pot $24.12 | Rake $1.21
Board [2c 6h 7d 5c 8s]
Seat 1: jimjames32 (big blind) mucked
Seat 2: HHnguyen15 folded before Flop (didn't bet)
Seat 3: 3JackOFF showed [9d Ah] and won ($22.91) with a straight, Five to Nine
Seat 4: kjs609 folded before Flop (didn't bet)
Seat 5: Pierson2323 (button) folded before Flop (didn't bet)
Seat 6: poppy20633 (small blind) folded on the River


PokerStars Hand #232991555504:  Hold'em No Limit ($1/$2 USD) - 2022/01/16 10:28:39 ET
Table 'Atalante' 6-max Seat #6 is the button
Seat 1: jimjames32 ($282.46 in chips)
Seat 2: HHnguyen15 ($159.86 in chips)
Seat 3: 3JackOFF ($239.67 in chips)
Seat 4: kjs609 ($190 in chips)
Seat 5: Pierson2323 ($337.75 in chips)
Seat 6: poppy20633 ($181.38 in chips)
jimjames32: posts small blind $1
HHnguyen15: posts big blind $2
*** HOLE CARDS ***
3JackOFF: folds
kjs609: folds
Pierson2323: raises $4 to $6
poppy20633: calls $6
jimjames32: folds
HHnguyen15: raises $19 to $25
Pierson2323: calls $19
poppy20633: folds
*** FLOP *** [5h Kc 3h]
HHnguyen15: bets $134.86 and is all-in
Pierson2323: folds
Uncalled bet ($134.86) returned to HHnguyen15
HHnguyen15 collected $54.15 from pot
HHnguyen15: doesn't show hand
*** SUMMARY ***
Total pot $57 | Rake $2.85
Board [5h Kc 3h]
Seat 1: jimjames32 (small blind) folded before Flop
Seat 2: HHnguyen15 (big blind) collected ($54.15)
Seat 3: 3JackOFF folded before Flop (didn't bet)
Seat 4: kjs609 folded before Flop (didn't bet)
Seat 5: Pierson2323 folded on the Flop
Seat 6: poppy20633 (button) folded before Flop


PokerStars Hand #232991555613:  Hold'em No Limit ($1/$2 USD) - 2022/01/16 10:29:03 ET
Table 'Atalante' 6-max Seat #1 is the button
Seat 1: jimjames32 ($281.46 in chips)
Seat 2: HHnguyen15 ($189.01 in chips)
Seat 3: 3JackOFF ($239.67 in chips)
Seat 4: kjs609 ($190 in chips)
Seat 5: Pierson2323 ($312.75 in chips)
Seat 6: poppy20633 ($175.38 in chips)
HHnguyen15: posts small blind $1
3JackOFF: posts big blind $2
*** HOLE CARDS ***
kjs609: folds
Pierson2323: raises $4 to $6
poppy20633: calls $6
jimjames32: folds
HHnguyen15: folds
3JackOFF: calls $4
*** FLOP *** [Ks Jh 6d]
3JackOFF: checks
Pierson2323: bets $12
poppy20633: folds
3JackOFF: calls $12
*** TURN *** [Ks Jh 6d] [Jd]
3JackOFF: checks
Pierson2323: checks
*** RIVER *** [Ks Jh 6d Jd] [5s]
3JackOFF: bets $58.82
Pierson2323 said, "smack the J on the turn"
Pierson2323 said, "some random hand like always lol"
Pierson2323: calls $58.82
*** SHOW DOWN ***
3JackOFF: shows [Qs Js] (three of a kind, Jacks)
Pierson2323: mucks hand
3JackOFF collected $157.64 from pot
*** SUMMARY ***
Total pot $160.64 | Rake $3
Board [Ks Jh 6d Jd 5s]
Seat 1: jimjames32 (button) folded before Flop (didn't bet)
Seat 2: HHnguyen15 (small blind) folded before Flop
Seat 3: 3JackOFF (big blind) showed [Qs Js] and won ($157.64) with three of a kind, Jacks
Seat 4: kjs609 folded before Flop (didn't bet)
Seat 5: Pierson2323 mucked
Seat 6: poppy20633 folded on the Flop


PokerStars Hand #232991555862:  Hold'em No Limit ($1/$2 USD) - 2022/01/16 10:30:01 ET
Table 'Atalante' 6-max Seat #2 is the button
Seat 1: jimjames32 ($281.46 in chips)
Seat 2: HHnguyen15 ($188.01 in chips)
Seat 3: 3JackOFF ($320.49 in chips)
Seat 4: kjs609 ($190 in chips)
Seat 5: Pierson2323 ($235.93 in chips)
Seat 6: poppy20633 ($200 in chips)
3JackOFF: posts small blind $1
kjs609: posts big blind $2
*** HOLE CARDS ***
Pierson2323 said, "nice life"
Pierson2323: raises $4 to $6
poppy20633: calls $6
jimjames32: folds
HHnguyen15: folds
3JackOFF: folds
kjs609: folds
*** FLOP *** [7s 6h 3d]
Pierson2323: checks
poppy20633: checks
*** TURN *** [7s 6h 3d] [3h]
Pierson2323: checks
poppy20633: checks
*** RIVER *** [7s 6h 3d 3h] [2h]
Pierson2323: checks
poppy20633: checks
*** SHOW DOWN ***
Pierson2323: shows [Jh Td] (a pair of Threes)
poppy20633: shows [Ad 4d] (a pair of Threes - Ace kicker)
poppy20633 collected $14.25 from pot
*** SUMMARY ***
Total pot $15 | Rake $0.75
Board [7s 6h 3d 3h 2h]
Seat 1: jimjames32 folded before Flop (didn't bet)
Seat 2: HHnguyen15 (button) folded before Flop (didn't bet)
Seat 3: 3JackOFF (small blind) folded before Flop
Seat 4: kjs609 (big blind) folded before Flop
Seat 5: Pierson2323 showed [Jh Td] and lost with a pair of Threes
Seat 6: poppy20633 showed [Ad 4d] and won ($14.25) with a pair of Threes


PokerStars Hand #232991555987:  Hold'em No Limit ($1/$2 USD) - 2022/01/16 10:30:27 ET
Table 'Atalante' 6-max Seat #3 is the button
Seat 1: jimjames32 ($281.46 in chips)
Seat 2: HHnguyen15 ($188.01 in chips)
Seat 3: 3JackOFF ($319.49 in chips)
Seat 4: kjs609 ($188 in chips)
Seat 5: Pierson2323 ($229.93 in chips)
Seat 6: poppy20633 ($208.25 in chips)
kjs609: posts small blind $1
Pierson2323: posts big blind $2
*** HOLE CARDS ***
poppy20633: calls $2
jimjames32: calls $2
HHnguyen15: calls $2
3JackOFF: folds
kjs609: calls $1
Pierson2323: checks
*** FLOP *** [6s 8c Qh]
kjs609: checks
Pierson2323: checks
poppy20633: checks
jimjames32: bets $4.75
HHnguyen15: folds
kjs609: folds
Pierson2323: folds
poppy20633: calls $4.75
*** TURN *** [6s 8c Qh] [6c]
poppy20633: checks
jimjames32: checks
*** RIVER *** [6s 8c Qh 6c] [9c]
poppy20633: checks
jimjames32: bets $2
poppy20633: folds
Uncalled bet ($2) returned to jimjames32
jimjames32 collected $18.52 from pot
jimjames32: doesn't show hand
*** SUMMARY ***
Total pot $19.50 | Rake $0.98
Board [6s 8c Qh 6c 9c]
Seat 1: jimjames32 collected ($18.52)
Seat 2: HHnguyen15 folded on the Flop
Seat 3: 3JackOFF (button) folded before Flop (didn't bet)
Seat 4: kjs609 (small blind) folded on the Flop
Seat 5: Pierson2323 (big blind) folded on the Flop
Seat 6: poppy20633 folded on the River


PokerStars Hand #232991556187:  Hold'em No Limit ($1/$2 USD) - 2022/01/16 10:31:12 ET
Table 'Atalante' 6-max Seat #4 is the button
Seat 1: jimjames32 ($293.23 in chips)
Seat 2: HHnguyen15 ($186.01 in chips)
Seat 3: 3JackOFF ($319.49 in chips)
Seat 4: kjs609 ($186 in chips)
Seat 5: Pierson2323 ($227.93 in chips)
Seat 6: poppy20633 ($201.50 in chips)
Pierson2323: posts small blind $1
poppy20633: posts big blind $2
*** HOLE CARDS ***
jimjames32: raises $4 to $6
HHnguyen15: folds
3JackOFF: folds
kjs609: folds
Pierson2323: folds
poppy20633: folds
Uncalled bet ($4) returned to jimjames32
jimjames32 collected $5 from pot
jimjames32: doesn't show hand
*** SUMMARY ***
Total pot $5 | Rake $0
Seat 1: jimjames32 collected ($5)
Seat 2: HHnguyen15 folded before Flop (didn't bet)
Seat 3: 3JackOFF folded before Flop (didn't bet)
Seat 4: kjs609 (button) folded before Flop (didn't bet)
Seat 5: Pierson2323 (small blind) folded before Flop
Seat 6: poppy20633 (big blind) folded before Flop


PokerStars Hand #232991556231:  Hold'em No Limit ($1/$2 USD) - 2022/01/16 10:31:23 ET
Table 'Atalante' 6-max Seat #5 is the button
Seat 1: jimjames32 ($296.23 in chips)
Seat 2: HHnguyen15 ($186.01 in chips)
Seat 3: 3JackOFF ($319.49 in chips)
Seat 4: kjs609 ($186 in chips)
Seat 5: Pierson2323 ($226.93 in chips)
Seat 6: poppy20633 ($199.50 in chips)
poppy20633: posts small blind $1
jimjames32: posts big blind $2
*** HOLE CARDS ***
HHnguyen15: folds
3JackOFF: folds
kjs609: folds
Pierson2323: folds
poppy20633: calls $1
jimjames32: checks
*** FLOP *** [Qh Kc Qd]
poppy20633: checks
jimjames32: bets $2
poppy20633: folds
Uncalled bet ($2) returned to jimjames32
jimjames32 collected $3.80 from pot
jimjames32: doesn't show hand
*** SUMMARY ***
Total pot $4 | Rake $0.20
Board [Qh Kc Qd]
Seat 1: jimjames32 (big blind) collected ($3.80)
Seat 2: HHnguyen15 folded before Flop (didn't bet)
Seat 3: 3JackOFF folded before Flop (didn't bet)
Seat 4: kjs609 folded before Flop (didn't bet)
Seat 5: Pierson2323 (button) folded before Flop (didn't bet)
Seat 6: poppy20633 (small blind) folded on the Flop


PokerStars Hand #232991556301:  Hold'em No Limit ($1/$2 USD) - 2022/01/16 10:31:41 ET
Table 'Atalante' 6-max Seat #6 is the button
Seat 1: jimjames32 ($298.03 in chips)
Seat 2: HHnguyen15 ($186.01 in chips)
Seat 3: 3JackOFF ($319.49 in chips)
Seat 4: kjs609 ($186 in chips)
Seat 5: Pierson2323 ($226.93 in chips)
Seat 6: poppy20633 ($197.50 in chips)
jimjames32: posts small blind $1
HHnguyen15: posts big blind $2
*** HOLE CARDS ***
3JackOFF: raises $3 to $5
kjs609: folds
Pierson2323: folds
poppy20633: folds
jimjames32: calls $4
HHnguyen15: calls $3
*** FLOP *** [8h Ah Kc]
jimjames32: checks
HHnguyen15: checks
3JackOFF: bets $9.12
jimjames32: folds
HHnguyen15: calls $9.12
*** TURN *** [8h Ah Kc] [7h]
HHnguyen15: checks
3JackOFF: bets $15.19
HHnguyen15: calls $15.19
*** RIVER *** [8h Ah Kc 7h] [Kd]
HHnguyen15: checks
3JackOFF: checks
*** SHOW DOWN ***
HHnguyen15: shows [Jh Tc] (a pair of Kings)
3JackOFF: shows [7d Ad] (two pair, Aces and Kings)
3JackOFF collected $60.62 from pot
*** SUMMARY ***
Total pot $63.62 | Rake $3
Board [8h Ah Kc 7h Kd]
Seat 1: jimjames32 (small blind) folded on the Flop
Seat 2: HHnguyen15 (big blind) showed [Jh Tc] and lost with a pair of Kings
Seat 3: 3JackOFF showed [7d Ad] and won ($60.62) with two pair, Aces and Kings
Seat 4: kjs609 folded before Flop (didn't bet)
Seat 5: Pierson2323 folded before Flop (didn't bet)
Seat 6: poppy20633 (button) folded before Flop (didn't bet)


PokerStars Hand #232991556447:  Hold'em No Limit ($1/$2 USD) - 2022/01/16 10:32:16 ET
Table 'Atalante' 6-max Seat #1 is the button
Seat 1: jimjames32 ($293.03 in chips)
Seat 2: HHnguyen15 ($156.70 in chips)
Seat 3: 3JackOFF ($350.80 in chips)
Seat 4: kjs609 ($186 in chips)
Seat 5: Pierson2323 ($226.93 in chips)
Seat 6: poppy20633 ($197.50 in chips)
HHnguyen15: posts small blind $1
3JackOFF: posts big blind $2
*** HOLE CARDS ***
kjs609: folds
Pierson2323: folds
poppy20633: folds
jimjames32: folds
HHnguyen15: calls $1
3JackOFF: raises $6 to $8
HHnguyen15: calls $6
*** FLOP *** [9h 6c Ac]
HHnguyen15: checks
3JackOFF: bets $6.40
HHnguyen15: folds
Uncalled bet ($6.40) returned to 3JackOFF
3JackOFF collected $15.20 from pot
3JackOFF: doesn't show hand
*** SUMMARY ***
Total pot $16 | Rake $0.80
Board [9h 6c Ac]
Seat 1: jimjames32 (button) folded before Flop (didn't bet)
Seat 2: HHnguyen15 (small blind) folded on the Flop
Seat 3: 3JackOFF (big blind) collected ($15.20)
Seat 4: kjs609 folded before Flop (didn't bet)
Seat 5: Pierson2323 folded before Flop (didn't bet)
Seat 6: poppy20633 folded before Flop (didn't bet)


PokerStars Hand #232991556565:  Hold'em No Limit ($1/$2 USD) - 2022/01/16 10:32:43 ET
Table 'Atalante' 6-max Seat #2 is the button
Seat 1: jimjames32 ($293.03 in chips)
Seat 2: HHnguyen15 ($148.70 in chips)
Seat 3: 3JackOFF ($358 in chips)
Seat 4: kjs609 ($186 in chips)
Seat 5: Pierson2323 ($226.93 in chips)
Seat 6: poppy20633 ($197.50 in chips)
3JackOFF: posts small blind $1
kjs609: posts big blind $2
*** HOLE CARDS ***
Pierson2323: raises $4 to $6
poppy20633: calls $6
jimjames32: calls $6
HHnguyen15: folds
3JackOFF: folds
kjs609: folds
*** FLOP *** [3s 3h Kc]
Pierson2323: checks
poppy20633: checks
jimjames32: checks
*** TURN *** [3s 3h Kc] [Ks]
Pierson2323: bets $6
poppy20633: folds
jimjames32: folds
Uncalled bet ($6) returned to Pierson2323
Pierson2323 collected $19.95 from pot
Pierson2323: doesn't show hand
*** SUMMARY ***
Total pot $21 | Rake $1.05
Board [3s 3h Kc Ks]
Seat 1: jimjames32 folded on the Turn
Seat 2: HHnguyen15 (button) folded before Flop (didn't bet)
Seat 3: 3JackOFF (small blind) folded before Flop
Seat 4: kjs609 (big blind) folded before Flop
Seat 5: Pierson2323 collected ($19.95)
Seat 6: poppy20633 folded on the Turn


PokerStars Hand #232991556683:  Hold'em No Limit ($1/$2 USD) - 2022/01/16 10:33:11 ET
Table 'Atalante' 6-max Seat #3 is the button
Seat 1: jimjames32 ($287.03 in chips)
Seat 2: HHnguyen15 ($148.70 in chips)
Seat 3: 3JackOFF ($357 in chips)
Seat 4: kjs609 ($184 in chips)
Seat 5: Pierson2323 ($240.88 in chips)
Seat 6: poppy20633 ($191.50 in chips)
kjs609: posts small blind $1
Pierson2323: posts big blind $2
*** HOLE CARDS ***
poppy20633: folds
jimjames32: folds
HHnguyen15: folds
3JackOFF: raises $4 to $6
kjs609: calls $5
Pierson2323: raises $20 to $26
3JackOFF: folds
kjs609: calls $20
*** FLOP *** [3c 6c 9s]
kjs609: checks
Pierson2323: bets $34
kjs609: calls $34
*** TURN *** [3c 6c 9s] [Tc]
kjs609: bets $61.50
Pierson2323: raises $119.38 to $180.88 and is all-in
poppy20633 is disconnected
kjs609: calls $62.50 and is all-in
Uncalled bet ($56.88) returned to Pierson2323
*** RIVER *** [3c 6c 9s Tc] [Qc]
*** SHOW DOWN ***
kjs609: shows [Js Jh] (a pair of Jacks)
Pierson2323: shows [Kc Ac] (a flush, Ace high)
Pierson2323 collected $371 from pot
*** SUMMARY ***
Total pot $374 | Rake $3
Board [3c 6c 9s Tc Qc]
Seat 1: jimjames32 folded before Flop (didn't bet)
Seat 2: HHnguyen15 folded before Flop (didn't bet)
Seat 3: 3JackOFF (button) folded before Flop
Seat 4: kjs609 (small blind) showed [Js Jh] and lost with a pair of Jacks
Seat 5: Pierson2323 (big blind) showed [Kc Ac] and won ($371) with a flush, Ace high
Seat 6: poppy20633 folded before Flop (didn't bet)


PokerStars Hand #232991556901:  Hold'em No Limit ($1/$2 USD) - 2022/01/16 10:34:04 ET
Table 'Atalante' 6-max Seat #5 is the button
Seat 2: HHnguyen15 ($148.70 in chips)
Seat 3: 3JackOFF ($351 in chips)
Seat 5: Pierson2323 ($427.88 in chips)
HHnguyen15: posts small blind $1
3JackOFF: posts big blind $2
*** HOLE CARDS ***
Pierson2323: folds
HHnguyen15: calls $1
kjs609 leaves the table
3JackOFF: raises $6 to $8
HHnguyen15: folds
Uncalled bet ($6) returned to 3JackOFF
MiltonBradley joins the table at seat #4
3JackOFF collected $4 from pot
3JackOFF: doesn't show hand
*** SUMMARY ***
Total pot $4 | Rake $0
Seat 2: HHnguyen15 (small blind) folded before Flop
Seat 3: 3JackOFF (big blind) collected ($4)
Seat 5: Pierson2323 (button) folded before Flop (didn't bet)


PokerStars Hand #232991556957:  Hold'em No Limit ($1/$2 USD) - 2022/01/16 10:34:18 ET
Table 'Atalante' 6-max Seat #2 is the button
Seat 2: HHnguyen15 ($146.70 in chips)
Seat 3: 3JackOFF ($353 in chips)
Seat 4: MiltonBradley ($200 in chips)
Seat 5: Pierson2323 ($427.88 in chips)
3JackOFF: posts small blind $1
MiltonBradley: posts big blind $2
*** HOLE CARDS ***
Pierson2323: folds
HHnguyen15: calls $2
3JackOFF: calls $1
MiltonBradley: checks
*** FLOP *** [Jd 5s 5d]
3JackOFF: checks
MiltonBradley: checks
HHnguyen15: bets $5.70
3JackOFF: folds
MiltonBradley: folds
Uncalled bet ($5.70) returned to HHnguyen15
HHnguyen15 collected $5.70 from pot
HHnguyen15: doesn't show hand
*** SUMMARY ***
Total pot $6 | Rake $0.30
Board [Jd 5s 5d]
Seat 2: HHnguyen15 (button) collected ($5.70)
Seat 3: 3JackOFF (small blind) folded on the Flop
Seat 4: MiltonBradley (big blind) folded on the Flop
Seat 5: Pierson2323 folded before Flop (didn't bet)


PokerStars Hand #232991557082:  Hold'em No Limit ($1/$2 USD) - 2022/01/16 10:34:49 ET
Table 'Atalante' 6-max Seat #3 is the button
Seat 2: HHnguyen15 ($150.40 in chips)
Seat 3: 3JackOFF ($351 in chips)
Seat 4: MiltonBradley ($200 in chips)
Seat 5: Pierson2323 ($427.88 in chips)
MiltonBradley: posts small blind $1
Pierson2323: posts big blind $2
*** HOLE CARDS ***
HHnguyen15: folds
3JackOFF: folds
MiltonBradley: folds
Uncalled bet ($1) returned to Pierson2323
Pierson2323 collected $2 from pot
*** SUMMARY ***
Total pot $2 | Rake $0
Seat 2: HHnguyen15 folded before Flop (didn't bet)
Seat 3: 3JackOFF (button) folded before Flop (didn't bet)
Seat 4: MiltonBradley (small blind) folded before Flop
Seat 5: Pierson2323 (big blind) collected ($2)


PokerStars Hand #232991557112:  Hold'em No Limit ($1/$2 USD) - 2022/01/16 10:34:55 ET
Table 'Atalante' 6-max Seat #4 is the button
Seat 2: HHnguyen15 ($150.40 in chips)
Seat 3: 3JackOFF ($351 in chips)
Seat 4: MiltonBradley ($200 in chips)
Seat 5: Pierson2323 ($428.88 in chips)
Pierson2323: posts small blind $1
HHnguyen15: posts big blind $2
*** HOLE CARDS ***
3JackOFF: raises $3 to $5
MiltonBradley: raises $9.88 to $14.88
Pierson2323: folds
HHnguyen15: folds
3JackOFF: folds
Uncalled bet ($9.88) returned to MiltonBradley
MiltonBradley collected $13 from pot
MiltonBradley: doesn't show hand
*** SUMMARY ***
Total pot $13 | Rake $0
Seat 2: HHnguyen15 (big blind) folded before Flop
Seat 3: 3JackOFF folded before Flop
Seat 4: MiltonBradley (button) collected ($13)
Seat 5: Pierson2323 (small blind) folded before Flop


PokerStars Hand #232991557171:  Hold'em No Limit ($1/$2 USD) - 2022/01/16 10:35:11 ET
Table 'Atalante' 6-max Seat #5 is the button
Seat 2: HHnguyen15 ($148.40 in chips)
Seat 3: 3JackOFF ($346 in chips)
Seat 4: MiltonBradley ($208 in chips)
Seat 5: Pierson2323 ($427.88 in chips)
HHnguyen15: posts small blind $1
3JackOFF: posts big blind $2
*** HOLE CARDS ***
MiltonBradley: raises $2.42 to $4.42
Pierson2323: folds
HHnguyen15: calls $3.42
3JackOFF: folds
*** FLOP *** [3s 4s 2s]
HHnguyen15: checks
MiltonBradley: bets $4.12
HHnguyen15: calls $4.12
*** TURN *** [3s 4s 2s] [Ts]
HHnguyen15: checks
MiltonBradley: checks
*** RIVER *** [3s 4s 2s Ts] [8h]
HHnguyen15: checks
MiltonBradley: bets $13.78
HHnguyen15: calls $13.78
*** SHOW DOWN ***
MiltonBradley: shows [Ks Js] (a flush, King high)
HHnguyen15: mucks hand
MiltonBradley collected $44.64 from pot
*** SUMMARY ***
Total pot $46.64 | Rake $2
Board [3s 4s 2s Ts 8h]
Seat 2: HHnguyen15 (small blind) mucked
Seat 3: 3JackOFF (big blind) folded before Flop
Seat 4: MiltonBradley showed [Ks Js] and won ($44.64) with a flush, King high
Seat 5: Pierson2323 (button) folded before Flop (didn't bet)


PokerStars Hand #232991557265:  Hold'em No Limit ($1/$2 USD) - 2022/01/16 10:35:37 ET
Table 'Atalante' 6-max Seat #2 is the button
Seat 2: HHnguyen15 ($126.08 in chips)
Seat 3: 3JackOFF ($344 in chips)
Seat 4: MiltonBradley ($230.32 in chips)
Seat 5: Pierson2323 ($427.88 in chips)
3JackOFF: posts small blind $1
MiltonBradley: posts big blind $2
jimjames32: sits out
*** HOLE CARDS ***
Pierson2323: folds
HHnguyen15: folds
3JackOFF: folds
Uncalled bet ($1) returned to MiltonBradley
MiltonBradley collected $2 from pot
MiltonBradley: doesn't show hand
*** SUMMARY ***
Total pot $2 | Rake $0
Seat 2: HHnguyen15 (button) folded before Flop (didn't bet)
Seat 3: 3JackOFF (small blind) folded before Flop
Seat 4: MiltonBradley (big blind) collected ($2)
Seat 5: Pierson2323 folded before Flop (didn't bet)


PokerStars Hand #232991557283:  Hold'em No Limit ($1/$2 USD) - 2022/01/16 10:35:43 ET
Table 'Atalante' 6-max Seat #3 is the button
Seat 2: HHnguyen15 ($126.08 in chips)
Seat 3: 3JackOFF ($343 in chips)
Seat 4: MiltonBradley ($231.32 in chips)
Seat 5: Pierson2323 ($427.88 in chips)
MiltonBradley: posts small blind $1
Pierson2323: posts big blind $2
jimjames32: sits out
*** HOLE CARDS ***
HHnguyen15: folds
3JackOFF: folds
MiltonBradley: folds
Uncalled bet ($1) returned to Pierson2323
Pierson2323 collected $2 from pot
*** SUMMARY ***
Total pot $2 | Rake $0
Seat 2: HHnguyen15 folded before Flop (didn't bet)
Seat 3: 3JackOFF (button) folded before Flop (didn't bet)
Seat 4: MiltonBradley (small blind) folded before Flop
Seat 5: Pierson2323 (big blind) collected ($2)


PokerStars Hand #232991557306:  Hold'em No Limit ($1/$2 USD) - 2022/01/16 10:35:50 ET
Table 'Atalante' 6-max Seat #4 is the button
Seat 1: jimjames32 ($287.03 in chips)
Seat 2: HHnguyen15 ($126.08 in chips)
Seat 3: 3JackOFF ($343 in chips)
Seat 4: MiltonBradley ($230.32 in chips)
Seat 5: Pierson2323 ($428.88 in chips)
Pierson2323: posts small blind $1
jimjames32: posts big blind $2
*** HOLE CARDS ***
HHnguyen15: calls $2
3JackOFF: folds
MiltonBradley: folds
Pierson2323: folds
jimjames32: checks
*** FLOP *** [6s Ac Th]
jimjames32: checks
HHnguyen15: checks
*** TURN *** [6s Ac Th] [Kd]
jimjames32: checks
HHnguyen15: checks
*** RIVER *** [6s Ac Th Kd] [5c]
jimjames32: bets $2
HHnguyen15: raises $8.75 to $10.75
jimjames32: calls $8.75
*** SHOW DOWN ***
HHnguyen15: shows [3c Ad] (a pair of Aces)
jimjames32: mucks hand
HHnguyen15 collected $25.18 from pot
*** SUMMARY ***
Total pot $26.50 | Rake $1.32
Board [6s Ac Th Kd 5c]
Seat 1: jimjames32 (big blind) mucked
Seat 2: HHnguyen15 showed [3c Ad] and won ($25.18) with a pair of Aces
Seat 3: 3JackOFF folded before Flop (didn't bet)
Seat 4: MiltonBradley (button) folded before Flop (didn't bet)
Seat 5: Pierson2323 (small blind) folded before Flop


PokerStars Hand #232991557392:  Hold'em No Limit ($1/$2 USD) - 2022/01/16 10:36:12 ET
Table 'Atalante' 6-max Seat #5 is the button
Seat 1: jimjames32 ($274.28 in chips)
Seat 2: HHnguyen15 ($138.51 in chips)
Seat 3: 3JackOFF ($343 in chips)
Seat 4: MiltonBradley ($230.32 in chips)
Seat 5: Pierson2323 ($427.88 in chips)
jimjames32: posts small blind $1
HHnguyen15: posts big blind $2
*** HOLE CARDS ***
3JackOFF: raises $3 to $5
MiltonBradley: folds
Pierson2323: folds
jimjames32: calls $4
HHnguyen15: calls $3
*** FLOP *** [3h 4c Td]
jimjames32: checks
HHnguyen15: checks
3JackOFF: bets $6.56
jimjames32: calls $6.56
HHnguyen15: folds
*** TURN *** [3h 4c Td] [6h]
jimjames32: checks
3JackOFF: checks
*** RIVER *** [3h 4c Td 6h] [Jd]
jimjames32: checks
3JackOFF: bets $20.30
jimjames32: folds
Uncalled bet ($20.30) returned to 3JackOFF
3JackOFF collected $26.71 from pot
3JackOFF: doesn't show hand
*** SUMMARY ***
Total pot $28.12 | Rake $1.41
Board [3h 4c Td 6h Jd]
Seat 1: jimjames32 (small blind) folded on the River
Seat 2: HHnguyen15 (big blind) folded on the Flop
Seat 3: 3JackOFF collected ($26.71)
Seat 4: MiltonBradley folded before Flop (didn't bet)
Seat 5: Pierson2323 (button) folded before Flop (didn't bet)


PokerStars Hand #232991557568:  Hold'em No Limit ($1/$2 USD) - 2022/01/16 10:36:54 ET
Table 'Atalante' 6-max Seat #1 is the button
Seat 1: jimjames32 ($262.72 in chips)
Seat 2: HHnguyen15 ($133.51 in chips)
Seat 3: 3JackOFF ($358.15 in chips)
Seat 4: MiltonBradley ($230.32 in chips)
Seat 5: Pierson2323 ($427.88 in chips)
HHnguyen15: posts small blind $1
3JackOFF: posts big blind $2
*** HOLE CARDS ***
MiltonBradley: raises $2.42 to $4.42
Pierson2323: calls $4.42
jimjames32: folds
HHnguyen15: calls $3.42
3JackOFF: folds
*** FLOP *** [Ac 7d Td]
HHnguyen15: checks
MiltonBradley: checks
Pierson2323: bets $7.25
HHnguyen15: folds
MiltonBradley: calls $7.25
*** TURN *** [Ac 7d Td] [2d]
MiltonBradley: checks
Pierson2323: checks
*** RIVER *** [Ac 7d Td 2d] [4c]
MiltonBradley: checks
Pierson2323: bets $18
MiltonBradley: folds
Uncalled bet ($18) returned to Pierson2323
Pierson2323 collected $28.27 from pot
Pierson2323: doesn't show hand
*** SUMMARY ***
Total pot $29.76 | Rake $1.49
Board [Ac 7d Td 2d 4c]
Seat 1: jimjames32 (button) folded before Flop (didn't bet)
Seat 2: HHnguyen15 (small blind) folded on the Flop
Seat 3: 3JackOFF (big blind) folded before Flop
Seat 4: MiltonBradley folded on the River
Seat 5: Pierson2323 collected ($28.27)


PokerStars Hand #232991557809:  Hold'em No Limit ($1/$2 USD) - 2022/01/16 10:37:56 ET
Table 'Atalante' 6-max Seat #2 is the button
Seat 1: jimjames32 ($262.72 in chips)
Seat 2: HHnguyen15 ($129.09 in chips)
Seat 3: 3JackOFF ($356.15 in chips)
Seat 4: MiltonBradley ($218.65 in chips)
Seat 5: Pierson2323 ($444.48 in chips)
3JackOFF: posts small blind $1
MiltonBradley: posts big blind $2
*** HOLE CARDS ***
Pierson2323: raises $4 to $6
jimjames32: folds
HHnguyen15: folds
3JackOFF: folds
MiltonBradley: folds
Uncalled bet ($4) returned to Pierson2323
Pierson2323 collected $5 from pot
*** SUMMARY ***
Total pot $5 | Rake $0
Seat 1: jimjames32 folded before Flop (didn't bet)
Seat 2: HHnguyen15 (button) folded before Flop (didn't bet)
Seat 3: 3JackOFF (small blind) folded before Flop
Seat 4: MiltonBradley (big blind) folded before Flop
Seat 5: Pierson2323 collected ($5)


PokerStars Hand #232991557836:  Hold'em No Limit ($1/$2 USD) - 2022/01/16 10:38:05 ET
Table 'Atalante' 6-max Seat #3 is the button
Seat 1: jimjames32 ($262.72 in chips)
Seat 2: HHnguyen15 ($129.09 in chips)
Seat 3: 3JackOFF ($355.15 in chips)
Seat 4: MiltonBradley ($216.65 in chips)
Seat 5: Pierson2323 ($447.48 in chips)
MiltonBradley: posts small blind $1
Pierson2323: posts big blind $2
*** HOLE CARDS ***
jimjames32: raises $4 to $6
HHnguyen15: folds
3JackOFF: folds
MiltonBradley: folds
Pierson2323: calls $4
*** FLOP *** [6s 5c Jc]
Pierson2323: checks
jimjames32: checks
*** TURN *** [6s 5c Jc] [As]
Pierson2323: checks
jimjames32: bets $6.17
Pierson2323: calls $6.17
*** RIVER *** [6s 5c Jc As] [6h]
Pierson2323: checks
jimjames32: checks
*** SHOW DOWN ***
Pierson2323: shows [Js Tc] (two pair, Jacks and Sixes)
jimjames32: shows [7d Ah] (two pair, Aces and Sixes)
jimjames32 collected $24.07 from pot
*** SUMMARY ***
Total pot $25.34 | Rake $1.27
Board [6s 5c Jc As 6h]
Seat 1: jimjames32 showed [7d Ah] and won ($24.07) with two pair, Aces and Sixes
Seat 2: HHnguyen15 folded before Flop (didn't bet)
Seat 3: 3JackOFF (button) folded before Flop (didn't bet)
Seat 4: MiltonBradley (small blind) folded before Flop
Seat 5: Pierson2323 (big blind) showed [Js Tc] and lost with two pair, Jacks and Sixes


PokerStars Hand #232991558002:  Hold'em No Limit ($1/$2 USD) - 2022/01/16 10:38:44 ET
Table 'Atalante' 6-max Seat #4 is the button
Seat 1: jimjames32 ($274.62 in chips)
Seat 2: HHnguyen15 ($129.09 in chips)
Seat 3: 3JackOFF ($355.15 in chips)
Seat 4: MiltonBradley ($215.65 in chips)
Seat 5: Pierson2323 ($435.31 in chips)
Pierson2323: posts small blind $1
jimjames32: posts big blind $2
*** HOLE CARDS ***
HHnguyen15: calls $2
3JackOFF: folds
MiltonBradley: folds
Pierson2323: folds
jimjames32: checks
*** FLOP *** [Ad 3h Kc]
jimjames32: bets $2
HHnguyen15: calls $2
*** TURN *** [Ad 3h Kc] [Qc]
jimjames32: checks
HHnguyen15: bets $8.55
jimjames32: folds
Uncalled bet ($8.55) returned to HHnguyen15
HHnguyen15 collected $8.55 from pot
HHnguyen15: doesn't show hand
*** SUMMARY ***
Total pot $9 | Rake $0.45
Board [Ad 3h Kc Qc]
Seat 1: jimjames32 (big blind) folded on the Turn
Seat 2: HHnguyen15 collected ($8.55)
Seat 3: 3JackOFF folded before Flop (didn't bet)
Seat 4: MiltonBradley (button) folded before Flop (didn't bet)
Seat 5: Pierson2323 (small blind) folded before Flop


PokerStars Hand #232991558113:  Hold'em No Limit ($1/$2 USD) - 2022/01/16 10:39:14 ET
Table 'Atalante' 6-max Seat #5 is the button
Seat 1: jimjames32 ($270.62 in chips)
Seat 2: HHnguyen15 ($133.64 in chips)
Seat 3: 3JackOFF ($355.15 in chips)
Seat 4: MiltonBradley ($215.65 in chips)
Seat 5: Pierson2323 ($434.31 in chips)
jimjames32: posts small blind $1
HHnguyen15: posts big blind $2
*** HOLE CARDS ***
3JackOFF: folds
MiltonBradley: folds
Pierson2323: folds
jimjames32: raises $4 to $6
HHnguyen15: calls $4
*** FLOP *** [Kh 4h 9c]
jimjames32: bets $5.70
HHnguyen15: folds
Uncalled bet ($5.70) returned to jimjames32
jimjames32 collected $11.40 from pot
jimjames32: doesn't show hand
*** SUMMARY ***
Total pot $12 | Rake $0.60
Board [Kh 4h 9c]
Seat 1: jimjames32 (small blind) collected ($11.40)
Seat 2: HHnguyen15 (big blind) folded on the Flop
Seat 3: 3JackOFF folded before Flop (didn't bet)
Seat 4: MiltonBradley folded before Flop (didn't bet)
Seat 5: Pierson2323 (button) folded before Flop (didn't bet)


PokerStars Hand #232991558173:  Hold'em No Limit ($1/$2 USD) - 2022/01/16 10:39:26 ET
Table 'Atalante' 6-max Seat #1 is the button
Seat 1: jimjames32 ($276.02 in chips)
Seat 2: HHnguyen15 ($127.64 in chips)
Seat 3: 3JackOFF ($355.15 in chips)
Seat 4: MiltonBradley ($215.65 in chips)
Seat 5: Pierson2323 ($434.31 in chips)
HHnguyen15: posts small blind $1
3JackOFF: posts big blind $2
*** HOLE CARDS ***
MiltonBradley: folds
Pierson2323: raises $4 to $6
jimjames32: calls $6
HHnguyen15: calls $5
3JackOFF: folds
*** FLOP *** [7d Td As]
HHnguyen15: checks
Pierson2323: bets $10
jimjames32: calls $10
HHnguyen15: calls $10
*** TURN *** [7d Td As] [5d]
HHnguyen15: checks
Pierson2323: checks
jimjames32: checks
*** RIVER *** [7d Td As 5d] [Tc]
HHnguyen15: checks
Pierson2323: checks
jimjames32: checks
*** SHOW DOWN ***
HHnguyen15: shows [8d Jc] (a pair of Tens)
Pierson2323: shows [7c Ac] (two pair, Aces and Tens)
jimjames32: mucks hand
Pierson2323 collected $47.50 from pot
*** SUMMARY ***
Total pot $50 | Rake $2.50
Board [7d Td As 5d Tc]
Seat 1: jimjames32 (button) mucked
Seat 2: HHnguyen15 (small blind) showed [8d Jc] and lost with a pair of Tens
Seat 3: 3JackOFF (big blind) folded before Flop
Seat 4: MiltonBradley folded before Flop (didn't bet)
Seat 5: Pierson2323 showed [7c Ac] and won ($47.50) with two pair, Aces and Tens


PokerStars Hand #232991558313:  Hold'em No Limit ($1/$2 USD) - 2022/01/16 10:39:56 ET
Table 'Atalante' 6-max Seat #2 is the button
Seat 1: jimjames32 ($260.02 in chips)
Seat 2: HHnguyen15 ($111.64 in chips)
Seat 3: 3JackOFF ($353.15 in chips)
Seat 4: MiltonBradley ($215.65 in chips)
Seat 5: Pierson2323 ($465.81 in chips)
3JackOFF: posts small blind $1
MiltonBradley: posts big blind $2
*** HOLE CARDS ***
Pierson2323: folds
jimjames32: folds
HHnguyen15: calls $2
3JackOFF: folds
MiltonBradley: checks
*** FLOP *** [6d 8h 8d]
MiltonBradley: bets $3.71
HHnguyen15: calls $3.71
*** TURN *** [6d 8h 8d] [Jh]
MiltonBradley: bets $7.91
HHnguyen15: calls $7.91
*** RIVER *** [6d 8h 8d Jh] [4c]
MiltonBradley: checks
HHnguyen15: checks
*** SHOW DOWN ***
MiltonBradley: shows [3d 7d] (a pair of Eights)
HHnguyen15: shows [9h 7h] (a pair of Eights - Jack+Nine kicker)
HHnguyen15 collected $26.83 from pot
*** SUMMARY ***
Total pot $28.24 | Rake $1.41
Board [6d 8h 8d Jh 4c]
Seat 1: jimjames32 folded before Flop (didn't bet)
Seat 2: HHnguyen15 (button) showed [9h 7h] and won ($26.83) with a pair of Eights
Seat 3: 3JackOFF (small blind) folded before Flop
Seat 4: MiltonBradley (big blind) showed [3d 7d] and lost with a pair of Eights
Seat 5: Pierson2323 folded before Flop (didn't bet)


PokerStars Hand #232991558552:  Hold'em No Limit ($1/$2 USD) - 2022/01/16 10:40:48 ET
Table 'Atalante' 6-max Seat #4 is the button
Seat 1: jimjames32 ($260.02 in chips)
Seat 2: HHnguyen15 ($127.60 in chips)
Seat 3: 3JackOFF ($352.15 in chips)
Seat 4: MiltonBradley ($201.03 in chips)
Seat 5: Pierson2323 ($463.81 in chips)
Pierson2323: posts small blind $1
jimjames32: posts big blind $2
*** HOLE CARDS ***
HHnguyen15: calls $2
3JackOFF: folds
MiltonBradley: raises $7 to $9
Pierson2323: folds
jimjames32: calls $7
HHnguyen15: folds
*** FLOP *** [2s 7c 5h]
jimjames32: checks
MiltonBradley: bets $7.98
jimjames32: calls $7.98
*** TURN *** [2s 7c 5h] [Jd]
jimjames32: checks
MiltonBradley: bets $11.24
jimjames32: folds
Uncalled bet ($11.24) returned to MiltonBradley
MiltonBradley collected $35.11 from pot
MiltonBradley: doesn't show hand
*** SUMMARY ***
Total pot $36.96 | Rake $1.85
Board [2s 7c 5h Jd]
Seat 1: jimjames32 (big blind) folded on the Turn
Seat 2: HHnguyen15 folded before Flop
Seat 3: 3JackOFF folded before Flop (didn't bet)
Seat 4: MiltonBradley (button) collected ($35.11)
Seat 5: Pierson2323 (small blind) folded before Flop


PokerStars Hand #232991558689:  Hold'em No Limit ($1/$2 USD) - 2022/01/16 10:41:20 ET
Table 'Atalante' 6-max Seat #5 is the button
Seat 1: jimjames32 ($243.04 in chips)
Seat 2: HHnguyen15 ($125.60 in chips)
Seat 3: 3JackOFF ($352.15 in chips)
Seat 4: MiltonBradley ($219.16 in chips)
Seat 5: Pierson2323 ($462.81 in chips)
jimjames32: posts small blind $1
HHnguyen15: posts big blind $2
*** HOLE CARDS ***
3JackOFF: folds
MiltonBradley: raises $2.18 to $4.18
Pierson2323: calls $4.18
jimjames32: calls $3.18
HHnguyen15: calls $2.18
*** FLOP *** [7d 2d 7s]
jimjames32: checks
HHnguyen15: checks
MiltonBradley: bets $5.08
Pierson2323: folds
jimjames32: calls $5.08
HHnguyen15: folds
*** TURN *** [7d 2d 7s] [9h]
jimjames32: checks
MiltonBradley: checks
*** RIVER *** [7d 2d 7s 9h] [Qc]
jimjames32: checks
MiltonBradley: checks
*** SHOW DOWN ***
jimjames32: shows [4d 5d] (a pair of Sevens)
MiltonBradley: shows [4c 2c] (two pair, Sevens and Deuces)
MiltonBradley collected $25.54 from pot
*** SUMMARY ***
Total pot $26.88 | Rake $1.34
Board [7d 2d 7s 9h Qc]
Seat 1: jimjames32 (small blind) showed [4d 5d] and lost with a pair of Sevens
Seat 2: HHnguyen15 (big blind) folded on the Flop
Seat 3: 3JackOFF folded before Flop (didn't bet)
Seat 4: MiltonBradley showed [4c 2c] and won ($25.54) with two pair, Sevens and Deuces
Seat 5: Pierson2323 (button) folded on the Flop


PokerStars Hand #232991558854:  Hold'em No Limit ($1/$2 USD) - 2022/01/16 10:42:01 ET
Table 'Atalante' 6-max Seat #1 is the button
Seat 1: jimjames32 ($233.78 in chips)
Seat 2: HHnguyen15 ($121.42 in chips)
Seat 3: 3JackOFF ($352.15 in chips)
Seat 4: MiltonBradley ($235.44 in chips)
Seat 5: Pierson2323 ($458.63 in chips)
HHnguyen15: posts small blind $1
3JackOFF: posts big blind $2
*** HOLE CARDS ***
MiltonBradley: folds
Pierson2323: folds
jimjames32: raises $4 to $6
HHnguyen15: calls $5
3JackOFF: folds
*** FLOP *** [Ad Kh 7h]
HHnguyen15: checks
jimjames32: checks
*** TURN *** [Ad Kh 7h] [2d]
HHnguyen15: checks
jimjames32: checks
*** RIVER *** [Ad Kh 7h 2d] [Kd]
HHnguyen15: checks
jimjames32: checks
*** SHOW DOWN ***
HHnguyen15: shows [5s 6s] (a pair of Kings)
jimjames32: shows [9c Qh] (a pair of Kings - Ace+Queen kicker)
jimjames32 collected $13.30 from pot
*** SUMMARY ***
Total pot $14 | Rake $0.70
Board [Ad Kh 7h 2d Kd]
Seat 1: jimjames32 (button) showed [9c Qh] and won ($13.30) with a pair of Kings
Seat 2: HHnguyen15 (small blind) showed [5s 6s] and lost with a pair of Kings
Seat 3: 3JackOFF (big blind) folded before Flop
Seat 4: MiltonBradley folded before Flop (didn't bet)
Seat 5: Pierson2323 folded before Flop (didn't bet)


PokerStars Hand #232991558984:  Hold'em No Limit ($1/$2 USD) - 2022/01/16 10:42:32 ET
Table 'Atalante' 6-max Seat #2 is the button
Seat 1: jimjames32 ($241.08 in chips)
Seat 2: HHnguyen15 ($115.42 in chips)
Seat 3: 3JackOFF ($350.15 in chips)
Seat 4: MiltonBradley ($235.44 in chips)
Seat 5: Pierson2323 ($458.63 in chips)
3JackOFF: posts small blind $1
MiltonBradley: posts big blind $2
*** HOLE CARDS ***
Pierson2323: raises $4 to $6
jimjames32: calls $6
HHnguyen15: folds
3JackOFF: folds
MiltonBradley: folds
*** FLOP *** [Kd Jd As]
Pierson2323: bets $4.99
jimjames32: calls $4.99
*** TURN *** [Kd Jd As] [Ah]
Pierson2323: bets $11.87
jimjames32: folds
Uncalled bet ($11.87) returned to Pierson2323
Pierson2323 collected $23.73 from pot
*** SUMMARY ***
Total pot $24.98 | Rake $1.25
Board [Kd Jd As Ah]
Seat 1: jimjames32 folded on the Turn
Seat 2: HHnguyen15 (button) folded before Flop (didn't bet)
Seat 3: 3JackOFF (small blind) folded before Flop
Seat 4: MiltonBradley (big blind) folded before Flop
Seat 5: Pierson2323 collected ($23.73)


PokerStars Hand #232991559088:  Hold'em No Limit ($1/$2 USD) - 2022/01/16 10:42:58 ET
Table 'Atalante' 6-max Seat #3 is the button
Seat 1: jimjames32 ($230.09 in chips)
Seat 2: HHnguyen15 ($115.42 in chips)
Seat 3: 3JackOFF ($349.15 in chips)
Seat 4: MiltonBradley ($233.44 in chips)
Seat 5: Pierson2323 ($471.37 in chips)
MiltonBradley: posts small blind $1
Pierson2323: posts big blind $2
*** HOLE CARDS ***
jimjames32: folds
HHnguyen15: calls $2
jimjames32 leaves the table
3JackOFF: raises $6 to $8
MiltonBradley: folds
Pierson2323: folds
HHnguyen15: calls $6
*** FLOP *** [2d Tc 4c]
HHnguyen15: checks
3JackOFF: checks
*** TURN *** [2d Tc 4c] [6d]
HHnguyen15: bets $18.05
3JackOFF: raises $48.26 to $66.31
HHnguyen15: folds
Uncalled bet ($48.26) returned to 3JackOFF
3JackOFF collected $52.34 from pot
3JackOFF: doesn't show hand
*** SUMMARY ***
Total pot $55.10 | Rake $2.76
Board [2d Tc 4c 6d]
Seat 1: jimjames32 folded before Flop (didn't bet)
Seat 2: HHnguyen15 folded on the Turn
Seat 3: 3JackOFF (button) collected ($52.34)
Seat 4: MiltonBradley (small blind) folded before Flop
Seat 5: Pierson2323 (big blind) folded before Flop


PokerStars Hand #232991559296:  Hold'em No Limit ($1/$2 USD) - 2022/01/16 10:43:47 ET
Table 'Atalante' 6-max Seat #4 is the button
Seat 2: HHnguyen15 ($89.37 in chips)
Seat 3: 3JackOFF ($375.44 in chips)
Seat 4: MiltonBradley ($232.44 in chips)
Seat 5: Pierson2323 ($469.37 in chips)
Pierson2323: posts small blind $1
HHnguyen15: posts big blind $2
*** HOLE CARDS ***
3JackOFF: folds
MiltonBradley: folds
poppy20633 was removed from the table for failing to post
poppy20633 leaves the table
Pierson2323: folds
Uncalled bet ($1) returned to HHnguyen15
HHnguyen15 collected $2 from pot
HHnguyen15: doesn't show hand
*** SUMMARY ***
Total pot $2 | Rake $0
Seat 2: HHnguyen15 (big blind) collected ($2)
Seat 3: 3JackOFF folded before Flop (didn't bet)
Seat 4: MiltonBradley (button) folded before Flop (didn't bet)
Seat 5: Pierson2323 (small blind) folded before Flop


PokerStars Hand #232991559350:  Hold'em No Limit ($1/$2 USD) - 2022/01/16 10:43:59 ET
Table 'Atalante' 6-max Seat #5 is the button
Seat 2: HHnguyen15 ($90.37 in chips)
Seat 3: 3JackOFF ($375.44 in chips)
Seat 4: MiltonBradley ($232.44 in chips)
Seat 5: Pierson2323 ($468.37 in chips)
HHnguyen15: posts small blind $1
3JackOFF: posts big blind $2
*** HOLE CARDS ***
MiltonBradley: raises $2.42 to $4.42
Pierson2323: folds
HHnguyen15: calls $3.42
3JackOFF: raises $20.58 to $25
MiltonBradley: folds
HHnguyen15: folds
Uncalled bet ($20.58) returned to 3JackOFF
3JackOFF collected $13.26 from pot
3JackOFF: doesn't show hand
*** SUMMARY ***
Total pot $13.26 | Rake $0
Seat 2: HHnguyen15 (small blind) folded before Flop
Seat 3: 3JackOFF (big blind) collected ($13.26)
Seat 4: MiltonBradley folded before Flop
Seat 5: Pierson2323 (button) folded before Flop (didn't bet)


PokerStars Hand #232991559460:  Hold'em No Limit ($1/$2 USD) - 2022/01/16 10:44:24 ET
Table 'Atalante' 6-max Seat #2 is the button
Seat 2: HHnguyen15 ($85.95 in chips)
Seat 3: 3JackOFF ($384.28 in chips)
Seat 4: MiltonBradley ($228.02 in chips)
Seat 5: Pierson2323 ($468.37 in chips)
3JackOFF: posts small blind $1
MiltonBradley: posts big blind $2
*** HOLE CARDS ***
Pierson2323: folds
HHnguyen15: folds
3JackOFF: folds
Uncalled bet ($1) returned to MiltonBradley
MiltonBradley collected $2 from pot
MiltonBradley: doesn't show hand
*** SUMMARY ***
Total pot $2 | Rake $0
Seat 2: HHnguyen15 (button) folded before Flop (didn't bet)
Seat 3: 3JackOFF (small blind) folded before Flop
Seat 4: MiltonBradley (big blind) collected ($2)
Seat 5: Pierson2323 folded before Flop (didn't bet)


PokerStars Hand #232991559516:  Hold'em No Limit ($1/$2 USD) - 2022/01/16 10:44:33 ET
Table 'Atalante' 6-max Seat #3 is the button
Seat 2: HHnguyen15 ($85.95 in chips)
Seat 3: 3JackOFF ($383.28 in chips)
Seat 4: MiltonBradley ($229.02 in chips)
Seat 5: Pierson2323 ($468.37 in chips)
MiltonBradley: posts small blind $1
Pierson2323: posts big blind $2
*** HOLE CARDS ***
HHnguyen15: calls $2
3JackOFF: folds
MiltonBradley: folds
Pierson2323: checks
*** FLOP *** [Tc Ts Ad]
Pierson2323: checks
HHnguyen15: checks
*** TURN *** [Tc Ts Ad] [3s]
Pierson2323: checks
iknewyouhadit joins the table at seat #1
HHnguyen15: checks
*** RIVER *** [Tc Ts Ad 3s] [6s]
Pierson2323: checks
HHnguyen15: checks
*** SHOW DOWN ***
Pierson2323: shows [4d Qc] (a pair of Tens)
HHnguyen15: mucks hand
Pierson2323 collected $4.75 from pot
*** SUMMARY ***
Total pot $5 | Rake $0.25
Board [Tc Ts Ad 3s 6s]
Seat 2: HHnguyen15 mucked
Seat 3: 3JackOFF (button) folded before Flop (didn't bet)
Seat 4: MiltonBradley (small blind) folded before Flop
Seat 5: Pierson2323 (big blind) showed [4d Qc] and won ($4.75) with a pair of Tens


PokerStars Hand #232991559608:  Hold'em No Limit ($1/$2 USD) - 2022/01/16 10:44:54 ET
Table 'Atalante' 6-max Seat #4 is the button
Seat 1: iknewyouhadit ($200 in chips)
Seat 2: HHnguyen15 ($83.95 in chips)
Seat 3: 3JackOFF ($383.28 in chips)
Seat 4: MiltonBradley ($228.02 in chips)
Seat 5: Pierson2323 ($471.12 in chips)
Pierson2323: posts small blind $1
iknewyouhadit: posts big blind $2
*** HOLE CARDS ***
HHnguyen15: calls $2
3JackOFF: folds
MiltonBradley: folds
Pierson2323: folds
iknewyouhadit: checks
*** FLOP *** [4c Ts Jh]
iknewyouhadit: checks
HHnguyen15: checks
*** TURN *** [4c Ts Jh] [Tc]
iknewyouhadit: checks
HHnguyen15: checks
*** RIVER *** [4c Ts Jh Tc] [Kc]
iknewyouhadit: checks
HHnguyen15: bets $4.75
iknewyouhadit: folds
Uncalled bet ($4.75) returned to HHnguyen15
HHnguyen15 collected $4.75 from pot
HHnguyen15: doesn't show hand
*** SUMMARY ***
Total pot $5 | Rake $0.25
Board [4c Ts Jh Tc Kc]
Seat 1: iknewyouhadit (big blind) folded on the River
Seat 2: HHnguyen15 collected ($4.75)
Seat 3: 3JackOFF folded before Flop (didn't bet)
Seat 4: MiltonBradley (button) folded before Flop (didn't bet)
Seat 5: Pierson2323 (small blind) folded before Flop


PokerStars Hand #232991559766:  Hold'em No Limit ($1/$2 USD) - 2022/01/16 10:45:27 ET
Table 'Atalante' 6-max Seat #5 is the button
Seat 1: iknewyouhadit ($200 in chips)
Seat 2: HHnguyen15 ($86.70 in chips)
Seat 3: 3JackOFF ($383.28 in chips)
Seat 4: MiltonBradley ($228.02 in chips)
Seat 5: Pierson2323 ($470.12 in chips)
iknewyouhadit: posts small blind $1
HHnguyen15: posts big blind $2
*** HOLE CARDS ***
3JackOFF: folds
MiltonBradley: folds
Pierson2323: folds
iknewyouhadit: calls $1
HHnguyen15: checks
*** FLOP *** [4c 9c Qh]
iknewyouhadit: checks
HHnguyen15: checks
*** TURN *** [4c 9c Qh] [5h]
iknewyouhadit: bets $2
HHnguyen15: folds
Uncalled bet ($2) returned to iknewyouhadit
iknewyouhadit collected $3.80 from pot
*** SUMMARY ***
Total pot $4 | Rake $0.20
Board [4c 9c Qh 5h]
Seat 1: iknewyouhadit (small blind) collected ($3.80)
Seat 2: HHnguyen15 (big blind) folded on the Turn
Seat 3: 3JackOFF folded before Flop (didn't bet)
Seat 4: MiltonBradley folded before Flop (didn't bet)
Seat 5: Pierson2323 (button) folded before Flop (didn't bet)


PokerStars Hand #232991559866:  Hold'em No Limit ($1/$2 USD) - 2022/01/16 10:45:49 ET
Table 'Atalante' 6-max Seat #1 is the button
Seat 1: iknewyouhadit ($201.80 in chips)
Seat 2: HHnguyen15 ($84.70 in chips)
Seat 3: 3JackOFF ($383.28 in chips)
Seat 4: MiltonBradley ($228.02 in chips)
Seat 5: Pierson2323 ($470.12 in chips)
HHnguyen15: posts small blind $1
3JackOFF: posts big blind $2
*** HOLE CARDS ***
MiltonBradley: folds
Pierson2323: folds
iknewyouhadit: folds
HHnguyen15: folds
Uncalled bet ($1) returned to 3JackOFF
3JackOFF collected $2 from pot
3JackOFF: doesn't show hand
*** SUMMARY ***
Total pot $2 | Rake $0
Seat 1: iknewyouhadit (button) folded before Flop (didn't bet)
Seat 2: HHnguyen15 (small blind) folded before Flop
Seat 3: 3JackOFF (big blind) collected ($2)
Seat 4: MiltonBradley folded before Flop (didn't bet)
Seat 5: Pierson2323 folded before Flop (didn't bet)


PokerStars Hand #232991559913:  Hold'em No Limit ($1/$2 USD) - 2022/01/16 10:45:58 ET
Table 'Atalante' 6-max Seat #2 is the button
Seat 1: iknewyouhadit ($201.80 in chips)
Seat 2: HHnguyen15 ($83.70 in chips)
Seat 3: 3JackOFF ($384.28 in chips)
Seat 4: MiltonBradley ($228.02 in chips)
Seat 5: Pierson2323 ($470.12 in chips)
3JackOFF: posts small blind $1
MiltonBradley: posts big blind $2
*** HOLE CARDS ***
win4dwddalways joins the table at seat #6
Pierson2323: raises $4 to $6
iknewyouhadit: folds
HHnguyen15: calls $6
3JackOFF: folds
MiltonBradley: calls $4
*** FLOP *** [4d 9c 4s]
MiltonBradley: checks
Pierson2323: bets $6.32
HHnguyen15: raises $71.38 to $77.70 and is all-in
MiltonBradley: folds
Pierson2323: folds
Uncalled bet ($71.38) returned to HHnguyen15
HHnguyen15 collected $30.06 from pot
HHnguyen15: doesn't show hand
*** SUMMARY ***
Total pot $31.64 | Rake $1.58
Board [4d 9c 4s]
Seat 1: iknewyouhadit folded before Flop (didn't bet)
Seat 2: HHnguyen15 (button) collected ($30.06)
Seat 3: 3JackOFF (small blind) folded before Flop
Seat 4: MiltonBradley (big blind) folded on the Flop
Seat 5: Pierson2323 folded on the Flop


PokerStars Hand #232991720736:  Hold'em No Limit ($1/$2 USD) - 2022/01/16 10:46:28 ET
Table 'Atalante' 6-max Seat #3 is the button
Seat 1: iknewyouhadit ($201.80 in chips)
Seat 2: HHnguyen15 ($101.44 in chips)
Seat 3: 3JackOFF ($383.28 in chips)
Seat 4: MiltonBradley ($222.02 in chips)
Seat 5: Pierson2323 ($457.80 in chips)
Seat 6: win4dwddalways ($200 in chips)
MiltonBradley: posts small blind $1
Pierson2323: posts big blind $2
win4dwddalways: posts big blind $2
*** HOLE CARDS ***
win4dwddalways: raises $4 to $6
iknewyouhadit: folds
HHnguyen15: folds
3JackOFF: folds
MiltonBradley: folds
Pierson2323: folds
Uncalled bet ($4) returned to win4dwddalways
win4dwddalways collected $5 from pot
win4dwddalways: doesn't show hand
*** SUMMARY ***
Total pot $5 | Rake $0
Seat 1: iknewyouhadit folded before Flop (didn't bet)
Seat 2: HHnguyen15 folded before Flop (didn't bet)
Seat 3: 3JackOFF (button) folded before Flop (didn't bet)
Seat 4: MiltonBradley (small blind) folded before Flop
Seat 5: Pierson2323 (big blind) folded before Flop
Seat 6: win4dwddalways collected ($5)


PokerStars Hand #232991720819:  Hold'em No Limit ($1/$2 USD) - 2022/01/16 10:46:45 ET
Table 'Atalante' 6-max Seat #4 is the button
Seat 1: iknewyouhadit ($201.80 in chips)
Seat 2: HHnguyen15 ($101.44 in chips)
Seat 3: 3JackOFF ($383.28 in chips)
Seat 4: MiltonBradley ($221.02 in chips)
Seat 5: Pierson2323 ($455.80 in chips)
Seat 6: win4dwddalways ($203 in chips)
Pierson2323: posts small blind $1
win4dwddalways: posts big blind $2
*** HOLE CARDS ***
iknewyouhadit: raises $2.60 to $4.60
HHnguyen15: calls $4.60
3JackOFF: raises $16.40 to $21
MiltonBradley: folds
Pierson2323: folds
win4dwddalways: folds
iknewyouhadit: folds
HHnguyen15: calls $16.40
*** FLOP *** [Ts Td 2s]
HHnguyen15: bets $80.44 and is all-in
3JackOFF: calls $80.44
*** TURN *** [Ts Td 2s] [7c]
*** RIVER *** [Ts Td 2s 7c] [2h]
*** SHOW DOWN ***
HHnguyen15: shows [As Qs] (two pair, Tens and Deuces)
3JackOFF: shows [Kd Kh] (two pair, Kings and Tens)
3JackOFF collected $207.48 from pot
*** SUMMARY ***
Total pot $210.48 | Rake $3
Board [Ts Td 2s 7c 2h]
Seat 1: iknewyouhadit folded before Flop
Seat 2: HHnguyen15 showed [As Qs] and lost with two pair, Tens and Deuces
Seat 3: 3JackOFF showed [Kd Kh] and won ($207.48) with two pair, Kings and Tens
Seat 4: MiltonBradley (button) folded before Flop (didn't bet)
Seat 5: Pierson2323 (small blind) folded before Flop
Seat 6: win4dwddalways (big blind) folded before Flop


PokerStars Hand #232991720998:  Hold'em No Limit ($1/$2 USD) - 2022/01/16 10:47:22 ET
Table 'Atalante' 6-max Seat #5 is the button
Seat 1: iknewyouhadit ($200 in chips)
Seat 3: 3JackOFF ($489.32 in chips)
Seat 4: MiltonBradley ($221.02 in chips)
Seat 5: Pierson2323 ($454.80 in chips)
Seat 6: win4dwddalways ($201 in chips)
win4dwddalways: posts small blind $1
iknewyouhadit: posts big blind $2
*** HOLE CARDS ***
3JackOFF: folds
MiltonBradley: folds
Pierson2323: raises $4 to $6
win4dwddalways: folds
iknewyouhadit: folds
Uncalled bet ($4) returned to Pierson2323
Pierson2323 collected $5 from pot
*** SUMMARY ***
Total pot $5 | Rake $0
Seat 1: iknewyouhadit (big blind) folded before Flop
Seat 3: 3JackOFF folded before Flop (didn't bet)
Seat 4: MiltonBradley folded before Flop (didn't bet)
Seat 5: Pierson2323 (button) collected ($5)
Seat 6: win4dwddalways (small blind) folded before Flop


PokerStars Hand #232991721050:  Hold'em No Limit ($1/$2 USD) - 2022/01/16 10:47:33 ET
Table 'Atalante' 6-max Seat #6 is the button
Seat 1: iknewyouhadit ($200 in chips)
Seat 4: MiltonBradley ($221.02 in chips)
Seat 5: Pierson2323 ($457.80 in chips)
Seat 6: win4dwddalways ($200 in chips)
iknewyouhadit: posts small blind $1
3JackOFF: is sitting out
MiltonBradley: posts big blind $2
*** HOLE CARDS ***
Pierson2323: folds
win4dwddalways: raises $4 to $6
iknewyouhadit: folds
MiltonBradley: folds
Uncalled bet ($4) returned to win4dwddalways
win4dwddalways collected $5 from pot
win4dwddalways: doesn't show hand
*** SUMMARY ***
Total pot $5 | Rake $0
Seat 1: iknewyouhadit (small blind) folded before Flop
Seat 4: MiltonBradley (big blind) folded before Flop
Seat 5: Pierson2323 folded before Flop (didn't bet)
Seat 6: win4dwddalways (button) collected ($5)


PokerStars Hand #232991721146:  Hold'em No Limit ($1/$2 USD) - 2022/01/16 10:47:53 ET
Table 'Atalante' 6-max Seat #1 is the button
Seat 1: iknewyouhadit ($200 in chips)
Seat 4: MiltonBradley ($219.02 in chips)
Seat 5: Pierson2323 ($457.80 in chips)
Seat 6: win4dwddalways ($203 in chips)
MiltonBradley: posts small blind $1
Pierson2323: posts big blind $2
*** HOLE CARDS ***
win4dwddalways: folds
iknewyouhadit: folds
MiltonBradley: raises $4 to $6
Pierson2323: folds
Uncalled bet ($4) returned to MiltonBradley
MiltonBradley collected $4 from pot
MiltonBradley: doesn't show hand
*** SUMMARY ***
Total pot $4 | Rake $0
Seat 1: iknewyouhadit (button) folded before Flop (didn't bet)
Seat 4: MiltonBradley (small blind) collected ($4)
Seat 5: Pierson2323 (big blind) folded before Flop
Seat 6: win4dwddalways folded before Flop (didn't bet)


PokerStars Hand #232991721232:  Hold'em No Limit ($1/$2 USD) - 2022/01/16 10:48:12 ET
Table 'Atalante' 6-max Seat #4 is the button
Seat 1: iknewyouhadit ($200 in chips)
Seat 2: HHnguyen15 ($80 in chips)
Seat 4: MiltonBradley ($221.02 in chips)
Seat 5: Pierson2323 ($455.80 in chips)
Seat 6: win4dwddalways ($203 in chips)
Pierson2323: posts small blind $1
win4dwddalways: posts big blind $2
HHnguyen15: posts small & big blinds $3
*** HOLE CARDS ***
iknewyouhadit: folds
HHnguyen15: raises $6 to $8
MiltonBradley: folds
Pierson2323: folds
win4dwddalways: folds
Uncalled bet ($6) returned to HHnguyen15
HHnguyen15 collected $6 from pot
HHnguyen15: doesn't show hand
*** SUMMARY ***
Total pot $6 | Rake $0
Seat 1: iknewyouhadit folded before Flop (didn't bet)
Seat 2: HHnguyen15 collected ($6)
Seat 4: MiltonBradley (button) folded before Flop (didn't bet)
Seat 5: Pierson2323 (small blind) folded before Flop
Seat 6: win4dwddalways (big blind) folded before Flop


PokerStars Hand #232991721311:  Hold'em No Limit ($1/$2 USD) - 2022/01/16 10:48:28 ET
Table 'Atalante' 6-max Seat #5 is the button
Seat 1: iknewyouhadit ($200 in chips)
Seat 2: HHnguyen15 ($83 in chips)
Seat 4: MiltonBradley ($221.02 in chips)
Seat 5: Pierson2323 ($454.80 in chips)
Seat 6: win4dwddalways ($201 in chips)
win4dwddalways: posts small blind $1
iknewyouhadit: posts big blind $2
*** HOLE CARDS ***
HHnguyen15: calls $2
MiltonBradley: folds
Pierson2323: folds
win4dwddalways: folds
iknewyouhadit: checks
*** FLOP *** [Qs 5s 2h]
iknewyouhadit: checks
HHnguyen15: checks
*** TURN *** [Qs 5s 2h] [3d]
iknewyouhadit: bets $3.61
HHnguyen15: folds
Uncalled bet ($3.61) returned to iknewyouhadit
iknewyouhadit collected $4.75 from pot
*** SUMMARY ***
Total pot $5 | Rake $0.25
Board [Qs 5s 2h 3d]
Seat 1: iknewyouhadit (big blind) collected ($4.75)
Seat 2: HHnguyen15 folded on the Turn
Seat 4: MiltonBradley folded before Flop (didn't bet)
Seat 5: Pierson2323 (button) folded before Flop (didn't bet)
Seat 6: win4dwddalways (small blind) folded before Flop


PokerStars Hand #232991721424:  Hold'em No Limit ($1/$2 USD) - 2022/01/16 10:48:54 ET
Table 'Atalante' 6-max Seat #6 is the button
Seat 1: iknewyouhadit ($202.75 in chips)
Seat 2: HHnguyen15 ($81 in chips)
Seat 4: MiltonBradley ($221.02 in chips)
Seat 5: Pierson2323 ($454.80 in chips)
Seat 6: win4dwddalways ($200 in chips)
iknewyouhadit: posts small blind $1
HHnguyen15: posts big blind $2
*** HOLE CARDS ***
MiltonBradley: folds
Pierson2323: folds
win4dwddalways: raises $4 to $6
iknewyouhadit: folds
HHnguyen15: calls $4
*** FLOP *** [8h 2s Kh]
HHnguyen15: checks
win4dwddalways: checks
*** TURN *** [8h 2s Kh] [Ah]
HHnguyen15: checks
win4dwddalways: bets $6.17
HHnguyen15: calls $6.17
*** RIVER *** [8h 2s Kh Ah] [9c]
HHnguyen15: checks
win4dwddalways: bets $12.03
HHnguyen15: folds
Uncalled bet ($12.03) returned to win4dwddalways
win4dwddalways collected $24.07 from pot
win4dwddalways: doesn't show hand
*** SUMMARY ***
Total pot $25.34 | Rake $1.27
Board [8h 2s Kh Ah 9c]
Seat 1: iknewyouhadit (small blind) folded before Flop
Seat 2: HHnguyen15 (big blind) folded on the River
Seat 4: MiltonBradley folded before Flop (didn't bet)
Seat 5: Pierson2323 folded before Flop (didn't bet)
Seat 6: win4dwddalways (button) collected ($24.07)


PokerStars Hand #232991721534:  Hold'em No Limit ($1/$2 USD) - 2022/01/16 10:49:18 ET
Table 'Atalante' 6-max Seat #1 is the button
Seat 1: iknewyouhadit ($201.75 in chips)
Seat 2: HHnguyen15 ($68.83 in chips)
Seat 4: MiltonBradley ($221.02 in chips)
Seat 5: Pierson2323 ($454.80 in chips)
Seat 6: win4dwddalways ($211.90 in chips)
HHnguyen15: posts small blind $1
MiltonBradley: posts big blind $2
*** HOLE CARDS ***
Pierson2323: raises $4 to $6
win4dwddalways: folds
iknewyouhadit: folds
HHnguyen15: calls $5
MiltonBradley: folds
*** FLOP *** [Td 5h Ad]
HHnguyen15: checks
Pierson2323: checks
*** TURN *** [Td 5h Ad] [Qd]
HHnguyen15: checks
Pierson2323: checks
*** RIVER *** [Td 5h Ad Qd] [2c]
HHnguyen15: checks
Pierson2323: checks
*** SHOW DOWN ***
HHnguyen15: shows [Ks 4c] (high card Ace)
Pierson2323: shows [8h 8s] (a pair of Eights)
Pierson2323 collected $13.30 from pot
*** SUMMARY ***
Total pot $14 | Rake $0.70
Board [Td 5h Ad Qd 2c]
Seat 1: iknewyouhadit (button) folded before Flop (didn't bet)
Seat 2: HHnguyen15 (small blind) showed [Ks 4c] and lost with high card Ace
Seat 4: MiltonBradley (big blind) folded before Flop
Seat 5: Pierson2323 showed [8h 8s] and won ($13.30) with a pair of Eights
Seat 6: win4dwddalways folded before Flop (didn't bet)


PokerStars Hand #232991721650:  Hold'em No Limit ($1/$2 USD) - 2022/01/16 10:49:42 ET
Table 'Atalante' 6-max Seat #2 is the button
Seat 1: iknewyouhadit ($201.75 in chips)
Seat 2: HHnguyen15 ($62.83 in chips)
Seat 4: MiltonBradley ($219.02 in chips)
Seat 5: Pierson2323 ($462.10 in chips)
Seat 6: win4dwddalways ($211.90 in chips)
MiltonBradley: posts small blind $1
Pierson2323: posts big blind $2
*** HOLE CARDS ***
win4dwddalways: folds
iknewyouhadit: folds
HHnguyen15: raises $60.83 to $62.83 and is all-in
MiltonBradley: calls $61.83
Pierson2323: folds
*** FLOP *** [2d 9d Tc]
*** TURN *** [2d 9d Tc] [2s]
*** RIVER *** [2d 9d Tc 2s] [3c]
*** SHOW DOWN ***
MiltonBradley: shows [Qc Qd] (two pair, Queens and Deuces)
HHnguyen15: shows [Jh Ac] (a pair of Deuces)
MiltonBradley collected $124.66 from pot
*** SUMMARY ***
Total pot $127.66 | Rake $3
Board [2d 9d Tc 2s 3c]
Seat 1: iknewyouhadit folded before Flop (didn't bet)
Seat 2: HHnguyen15 (button) showed [Jh Ac] and lost with a pair of Deuces
Seat 4: MiltonBradley (small blind) showed [Qc Qd] and won ($124.66) with two pair, Queens and Deuces
Seat 5: Pierson2323 (big blind) folded before Flop
Seat 6: win4dwddalways folded before Flop (didn't bet)


PokerStars Hand #232991721770:  Hold'em No Limit ($1/$2 USD) - 2022/01/16 10:50:09 ET
Table 'Atalante' 6-max Seat #4 is the button
Seat 1: iknewyouhadit ($201.75 in chips)
Seat 4: MiltonBradley ($280.85 in chips)
Seat 5: Pierson2323 ($460.10 in chips)
Seat 6: win4dwddalways ($211.90 in chips)
Pierson2323: posts small blind $1
win4dwddalways: posts big blind $2
*** HOLE CARDS ***
iknewyouhadit: folds
MiltonBradley: raises $2.18 to $4.18
3JackOFF leaves the table
Pierson2323: calls $3.18
win4dwddalways: calls $2.18
*** FLOP *** [9d 2s Ad]
Pierson2323: checks
win4dwddalways: checks
MiltonBradley: checks
*** TURN *** [9d 2s Ad] [7h]
Pierson2323: checks
win4dwddalways: bets $5.95
MiltonBradley: folds
Pierson2323: folds
Uncalled bet ($5.95) returned to win4dwddalways
win4dwddalways collected $11.91 from pot
win4dwddalways: doesn't show hand
*** SUMMARY ***
Total pot $12.54 | Rake $0.63
Board [9d 2s Ad 7h]
Seat 1: iknewyouhadit folded before Flop (didn't bet)
Seat 4: MiltonBradley (button) folded on the Turn
Seat 5: Pierson2323 (small blind) folded on the Turn
Seat 6: win4dwddalways (big blind) collected ($11.91)


PokerStars Hand #232991721893:  Hold'em No Limit ($1/$2 USD) - 2022/01/16 10:50:36 ET
Table 'Atalante' 6-max Seat #5 is the button
Seat 1: iknewyouhadit ($201.75 in chips)
Seat 2: HHnguyen15 ($120 in chips)
Seat 4: MiltonBradley ($276.67 in chips)
Seat 5: Pierson2323 ($455.92 in chips)
Seat 6: win4dwddalways ($219.63 in chips)
win4dwddalways: posts small blind $1
iknewyouhadit: posts big blind $2
*** HOLE CARDS ***
HHnguyen15: raises $5 to $7
MiltonBradley: folds
Pierson2323: folds
win4dwddalways: folds
iknewyouhadit: calls $5
*** FLOP *** [4s 5s 2c]
iknewyouhadit: checks
HHnguyen15: checks
*** TURN *** [4s 5s 2c] [6d]
iknewyouhadit: bets $10
HHnguyen15: calls $10
*** RIVER *** [4s 5s 2c 6d] [Qs]
iknewyouhadit: bets $10.97
HHnguyen15: folds
Uncalled bet ($10.97) returned to iknewyouhadit
iknewyouhadit collected $33.25 from pot
*** SUMMARY ***
Total pot $35 | Rake $1.75
Board [4s 5s 2c 6d Qs]
Seat 1: iknewyouhadit (big blind) collected ($33.25)
Seat 2: HHnguyen15 folded on the River
Seat 4: MiltonBradley folded before Flop (didn't bet)
Seat 5: Pierson2323 (button) folded before Flop (didn't bet)
Seat 6: win4dwddalways (small blind) folded before Flop


PokerStars Hand #232991722088:  Hold'em No Limit ($1/$2 USD) - 2022/01/16 10:51:19 ET
Table 'Atalante' 6-max Seat #6 is the button
Seat 1: iknewyouhadit ($218 in chips)
Seat 2: HHnguyen15 ($103 in chips)
Seat 4: MiltonBradley ($276.67 in chips)
Seat 5: Pierson2323 ($455.92 in chips)
Seat 6: win4dwddalways ($218.63 in chips)
iknewyouhadit: posts small blind $1
HHnguyen15: posts big blind $2
*** HOLE CARDS ***
MiltonBradley: folds
Pierson2323: raises $4 to $6
win4dwddalways: calls $6
iknewyouhadit: folds
HHnguyen15: calls $4
*** FLOP *** [Kd 2h 2s]
HHnguyen15: checks
Pierson2323: bets $9.03
win4dwddalways: folds
HHnguyen15: calls $9.03
*** TURN *** [Kd 2h 2s] [6c]
HHnguyen15: checks
Pierson2323: checks
*** RIVER *** [Kd 2h 2s 6c] [3h]
HHnguyen15: checks
Pierson2323: bets $8
HHnguyen15: folds
Uncalled bet ($8) returned to Pierson2323
Pierson2323 collected $35.21 from pot
Pierson2323: doesn't show hand
*** SUMMARY ***
Total pot $37.06 | Rake $1.85
Board [Kd 2h 2s 6c 3h]
Seat 1: iknewyouhadit (small blind) folded before Flop
Seat 2: HHnguyen15 (big blind) folded on the River
Seat 4: MiltonBradley folded before Flop (didn't bet)
Seat 5: Pierson2323 collected ($35.21)
Seat 6: win4dwddalways (button) folded on the Flop


PokerStars Hand #232991722347:  Hold'em No Limit ($1/$2 USD) - 2022/01/16 10:52:18 ET
Table 'Atalante' 6-max Seat #1 is the button
Seat 1: iknewyouhadit ($217 in chips)
Seat 2: HHnguyen15 ($87.97 in chips)
Seat 4: MiltonBradley ($276.67 in chips)
Seat 5: Pierson2323 ($476.10 in chips)
Seat 6: win4dwddalways ($212.63 in chips)
HHnguyen15: posts small blind $1
MiltonBradley: posts big blind $2
*** HOLE CARDS ***
Pierson2323: folds
win4dwddalways: raises $4 to $6
iknewyouhadit: folds
HHnguyen15: calls $5
MiltonBradley: calls $4
*** FLOP *** [4c 6h 6s]
HHnguyen15: checks
MiltonBradley: checks
win4dwddalways: checks
*** TURN *** [4c 6h 6s] [5d]
HHnguyen15: checks
MiltonBradley: checks
win4dwddalways: checks
*** RIVER *** [4c 6h 6s 5d] [8c]
HHnguyen15: checks
pizzadad9 joins the table at seat #3
MiltonBradley: checks
win4dwddalways: checks
*** SHOW DOWN ***
HHnguyen15: shows [9c Th] (a pair of Sixes)
MiltonBradley: shows [8s Qs] (two pair, Eights and Sixes)
win4dwddalways: mucks hand
MiltonBradley collected $17.10 from pot
*** SUMMARY ***
Total pot $18 | Rake $0.90
Board [4c 6h 6s 5d 8c]
Seat 1: iknewyouhadit (button) folded before Flop (didn't bet)
Seat 2: HHnguyen15 (small blind) showed [9c Th] and lost with a pair of Sixes
Seat 4: MiltonBradley (big blind) showed [8s Qs] and won ($17.10) with two pair, Eights and Sixes
Seat 5: Pierson2323 folded before Flop (didn't bet)
Seat 6: win4dwddalways mucked


PokerStars Hand #232991722594:  Hold'em No Limit ($1/$2 USD) - 2022/01/16 10:53:12 ET
Table 'Atalante' 6-max Seat #2 is the button
Seat 1: iknewyouhadit ($217 in chips)
Seat 2: HHnguyen15 ($81.97 in chips)
Seat 4: MiltonBradley ($287.77 in chips)
Seat 5: Pierson2323 ($476.10 in chips)
Seat 6: win4dwddalways ($206.63 in chips)
MiltonBradley: posts small blind $1
Pierson2323: posts big blind $2
*** HOLE CARDS ***
win4dwddalways: folds
iknewyouhadit: folds
HHnguyen15: folds
MiltonBradley: raises $4 to $6
Pierson2323: folds
Uncalled bet ($4) returned to MiltonBradley
MiltonBradley collected $4 from pot
MiltonBradley: doesn't show hand
*** SUMMARY ***
Total pot $4 | Rake $0
Seat 1: iknewyouhadit folded before Flop (didn't bet)
Seat 2: HHnguyen15 (button) folded before Flop (didn't bet)
Seat 4: MiltonBradley (small blind) collected ($4)
Seat 5: Pierson2323 (big blind) folded before Flop
Seat 6: win4dwddalways folded before Flop (didn't bet)


PokerStars Hand #232991722635:  Hold'em No Limit ($1/$2 USD) - 2022/01/16 10:53:23 ET
Table 'Atalante' 6-max Seat #4 is the button
Seat 1: iknewyouhadit ($217 in chips)
Seat 2: HHnguyen15 ($81.97 in chips)
Seat 4: MiltonBradley ($289.77 in chips)
Seat 5: Pierson2323 ($474.10 in chips)
Seat 6: win4dwddalways ($206.63 in chips)
Pierson2323: posts small blind $1
win4dwddalways: posts big blind $2
pizzadad9: sits out
*** HOLE CARDS ***
iknewyouhadit: folds
HHnguyen15: raises $5 to $7
MiltonBradley: folds
Pierson2323: folds
win4dwddalways: calls $5
*** FLOP *** [9h Qs 5c]
win4dwddalways: checks
HHnguyen15: checks
*** TURN *** [9h Qs 5c] [Qh]
win4dwddalways: bets $7.12
HHnguyen15: raises $7.12 to $14.24
win4dwddalways: folds
Uncalled bet ($7.12) returned to HHnguyen15
HHnguyen15 collected $27.78 from pot
HHnguyen15: doesn't show hand
*** SUMMARY ***
Total pot $29.24 | Rake $1.46
Board [9h Qs 5c Qh]
Seat 1: iknewyouhadit folded before Flop (didn't bet)
Seat 2: HHnguyen15 collected ($27.78)
Seat 4: MiltonBradley (button) folded before Flop (didn't bet)
Seat 5: Pierson2323 (small blind) folded before Flop
Seat 6: win4dwddalways (big blind) folded on the Turn


PokerStars Hand #232991722765:  Hold'em No Limit ($1/$2 USD) - 2022/01/16 10:53:54 ET
Table 'Atalante' 6-max Seat #5 is the button
Seat 1: iknewyouhadit ($217 in chips)
Seat 2: HHnguyen15 ($95.63 in chips)
Seat 4: MiltonBradley ($289.77 in chips)
Seat 5: Pierson2323 ($473.10 in chips)
Seat 6: win4dwddalways ($192.51 in chips)
win4dwddalways: posts small blind $1
iknewyouhadit: posts big blind $2
pizzadad9: sits out
*** HOLE CARDS ***
HHnguyen15: folds
MiltonBradley: folds
Pierson2323: raises $4 to $6
win4dwddalways: folds
iknewyouhadit: calls $4
*** FLOP *** [2d 5s 6h]
iknewyouhadit: checks
Pierson2323: bets $4
iknewyouhadit: folds
Uncalled bet ($4) returned to Pierson2323
Pierson2323 collected $12.35 from pot
*** SUMMARY ***
Total pot $13 | Rake $0.65
Board [2d 5s 6h]
Seat 1: iknewyouhadit (big blind) folded on the Flop
Seat 2: HHnguyen15 folded before Flop (didn't bet)
Seat 4: MiltonBradley folded before Flop (didn't bet)
Seat 5: Pierson2323 (button) collected ($12.35)
Seat 6: win4dwddalways (small blind) folded before Flop


PokerStars Hand #232991722874:  Hold'em No Limit ($1/$2 USD) - 2022/01/16 10:54:20 ET
Table 'Atalante' 6-max Seat #6 is the button
Seat 1: iknewyouhadit ($211 in chips)
Seat 2: HHnguyen15 ($95.63 in chips)
Seat 4: MiltonBradley ($289.77 in chips)
Seat 5: Pierson2323 ($479.45 in chips)
Seat 6: win4dwddalways ($191.51 in chips)
iknewyouhadit: posts small blind $1
HHnguyen15: posts big blind $2
pizzadad9: sits out
*** HOLE CARDS ***
MiltonBradley: folds
Pierson2323: folds
win4dwddalways: folds
iknewyouhadit: raises $4 to $6
HHnguyen15: calls $4
*** FLOP *** [2c Kd 3h]
iknewyouhadit: checks
HHnguyen15: checks
*** TURN *** [2c Kd 3h] [4c]
iknewyouhadit: checks
HHnguyen15: checks
*** RIVER *** [2c Kd 3h 4c] [2d]
iknewyouhadit: checks
HHnguyen15: checks
*** SHOW DOWN ***
iknewyouhadit: shows [6d As] (a pair of Deuces)
HHnguyen15: shows [Qs 3s] (two pair, Threes and Deuces)
HHnguyen15 collected $11.40 from pot
*** SUMMARY ***
Total pot $12 | Rake $0.60
Board [2c Kd 3h 4c 2d]
Seat 1: iknewyouhadit (small blind) showed [6d As] and lost with a pair of Deuces
Seat 2: HHnguyen15 (big blind) showed [Qs 3s] and won ($11.40) with two pair, Threes and Deuces
Seat 4: MiltonBradley folded before Flop (didn't bet)
Seat 5: Pierson2323 folded before Flop (didn't bet)
Seat 6: win4dwddalways (button) folded before Flop (didn't bet)


PokerStars Hand #232991723061:  Hold'em No Limit ($1/$2 USD) - 2022/01/16 10:55:01 ET
Table 'Atalante' 6-max Seat #1 is the button
Seat 1: iknewyouhadit ($205 in chips)
Seat 2: HHnguyen15 ($101.03 in chips)
Seat 3: pizzadad9 ($200 in chips)
Seat 4: MiltonBradley ($289.77 in chips)
Seat 5: Pierson2323 ($479.45 in chips)
Seat 6: win4dwddalways ($191.51 in chips)
HHnguyen15: posts small blind $1
pizzadad9: posts big blind $2
*** HOLE CARDS ***
MiltonBradley: folds
Pierson2323: raises $4 to $6
win4dwddalways: folds
iknewyouhadit: folds
HHnguyen15: calls $5
pizzadad9: raises $24 to $30
Pierson2323: folds
HHnguyen15: folds
Uncalled bet ($24) returned to pizzadad9
pizzadad9 collected $18 from pot
pizzadad9: doesn't show hand
*** SUMMARY ***
Total pot $18 | Rake $0
Seat 1: iknewyouhadit (button) folded before Flop (didn't bet)
Seat 2: HHnguyen15 (small blind) folded before Flop
Seat 3: pizzadad9 (big blind) collected ($18)
Seat 4: MiltonBradley folded before Flop (didn't bet)
Seat 5: Pierson2323 folded before Flop
Seat 6: win4dwddalways folded before Flop (didn't bet)


PokerStars Hand #232991723179:  Hold'em No Limit ($1/$2 USD) - 2022/01/16 10:55:28 ET
Table 'Atalante' 6-max Seat #2 is the button
Seat 1: iknewyouhadit ($205 in chips)
Seat 2: HHnguyen15 ($95.03 in chips)
Seat 3: pizzadad9 ($212 in chips)
Seat 4: MiltonBradley ($289.77 in chips)
Seat 5: Pierson2323 ($473.45 in chips)
Seat 6: win4dwddalways ($191.51 in chips)
pizzadad9: posts small blind $1
MiltonBradley: posts big blind $2
*** HOLE CARDS ***
Pierson2323: folds
win4dwddalways: raises $4 to $6
iknewyouhadit: folds
HHnguyen15: folds
pizzadad9: raises $18 to $24
MiltonBradley: folds
win4dwddalways: raises $28 to $52
pizzadad9: folds
Uncalled bet ($28) returned to win4dwddalways
win4dwddalways collected $50 from pot
win4dwddalways: doesn't show hand
*** SUMMARY ***
Total pot $50 | Rake $0
Seat 1: iknewyouhadit folded before Flop (didn't bet)
Seat 2: HHnguyen15 (button) folded before Flop (didn't bet)
Seat 3: pizzadad9 (small blind) folded before Flop
Seat 4: MiltonBradley (big blind) folded before Flop
Seat 5: Pierson2323 folded before Flop (didn't bet)
Seat 6: win4dwddalways collected ($50)


PokerStars Hand #232991723329:  Hold'em No Limit ($1/$2 USD) - 2022/01/16 10:56:04 ET
Table 'Atalante' 6-max Seat #3 is the button
Seat 1: iknewyouhadit ($205 in chips)
Seat 2: HHnguyen15 ($95.03 in chips)
Seat 3: pizzadad9 ($200 in chips)
Seat 4: MiltonBradley ($287.77 in chips)
Seat 5: Pierson2323 ($473.45 in chips)
Seat 6: win4dwddalways ($217.51 in chips)
MiltonBradley: posts small blind $1
Pierson2323: posts big blind $2
*** HOLE CARDS ***
win4dwddalways: folds
iknewyouhadit: folds
HHnguyen15: calls $2
pizzadad9: folds
MiltonBradley: raises $7 to $9
Pierson2323: folds
HHnguyen15: calls $7
*** FLOP *** [Tc 8d 3c]
MiltonBradley: checks
HHnguyen15: checks
*** TURN *** [Tc 8d 3c] [Qh]
MiltonBradley: checks
HHnguyen15: checks
*** RIVER *** [Tc 8d 3c Qh] [4h]
MiltonBradley: checks
HHnguyen15: checks
*** SHOW DOWN ***
MiltonBradley: shows [Kd As] (high card Ace)
HHnguyen15: mucks hand
MiltonBradley collected $19 from pot
*** SUMMARY ***
Total pot $20 | Rake $1
Board [Tc 8d 3c Qh 4h]
Seat 1: iknewyouhadit folded before Flop (didn't bet)
Seat 2: HHnguyen15 mucked
Seat 3: pizzadad9 (button) folded before Flop (didn't bet)
Seat 4: MiltonBradley (small blind) showed [Kd As] and won ($19) with high card Ace
Seat 5: Pierson2323 (big blind) folded before Flop
Seat 6: win4dwddalways folded before Flop (didn't bet)


PokerStars Hand #232991723569:  Hold'em No Limit ($1/$2 USD) - 2022/01/16 10:56:58 ET
Table 'Atalante' 6-max Seat #4 is the button
Seat 1: iknewyouhadit ($205 in chips)
Seat 2: HHnguyen15 ($86.03 in chips)
Seat 3: pizzadad9 ($200 in chips)
Seat 4: MiltonBradley ($297.77 in chips)
Seat 5: Pierson2323 ($471.45 in chips)
Seat 6: win4dwddalways ($217.51 in chips)
Pierson2323: posts small blind $1
win4dwddalways: posts big blind $2
*** HOLE CARDS ***
iknewyouhadit: folds
HHnguyen15: raises $5 to $7
pizzadad9: folds
MiltonBradley: calls $7
Pierson2323: calls $6
win4dwddalways: folds
*** FLOP *** [4c Jd 9s]
Pierson2323: checks
HHnguyen15: bets $10.92
MiltonBradley: calls $10.92
Pierson2323: calls $10.92
*** TURN *** [4c Jd 9s] [9h]
Pierson2323: checks
HHnguyen15: checks
MiltonBradley: checks
*** RIVER *** [4c Jd 9s 9h] [5d]
Pierson2323: checks
HHnguyen15: checks
MiltonBradley: bets $21.19
Pierson2323: folds
HHnguyen15: folds
Uncalled bet ($21.19) returned to MiltonBradley
MiltonBradley collected $52.97 from pot
MiltonBradley: doesn't show hand
*** SUMMARY ***
Total pot $55.76 | Rake $2.79
Board [4c Jd 9s 9h 5d]
Seat 1: iknewyouhadit folded before Flop (didn't bet)
Seat 2: HHnguyen15 folded on the River
Seat 3: pizzadad9 folded before Flop (didn't bet)
Seat 4: MiltonBradley (button) collected ($52.97)
Seat 5: Pierson2323 (small blind) folded on the River
Seat 6: win4dwddalways (big blind) folded before Flop


PokerStars Hand #232991723796:  Hold'em No Limit ($1/$2 USD) - 2022/01/16 10:57:42 ET
Table 'Atalante' 6-max Seat #5 is the button
Seat 1: iknewyouhadit ($205 in chips)
Seat 2: HHnguyen15 ($68.11 in chips)
Seat 3: pizzadad9 ($200 in chips)
Seat 4: MiltonBradley ($332.82 in chips)
Seat 5: Pierson2323 ($453.53 in chips)
Seat 6: win4dwddalways ($215.51 in chips)
win4dwddalways: posts small blind $1
iknewyouhadit: posts big blind $2
*** HOLE CARDS ***
HHnguyen15: calls $2
pizzadad9: folds
MiltonBradley: folds
Pierson2323: folds
win4dwddalways: raises $8 to $10
iknewyouhadit: folds
HHnguyen15: folds
Uncalled bet ($8) returned to win4dwddalways
win4dwddalways collected $6 from pot
win4dwddalways: doesn't show hand
*** SUMMARY ***
Total pot $6 | Rake $0
Seat 1: iknewyouhadit (big blind) folded before Flop
Seat 2: HHnguyen15 folded before Flop
Seat 3: pizzadad9 folded before Flop (didn't bet)
Seat 4: MiltonBradley folded before Flop (didn't bet)
Seat 5: Pierson2323 (button) folded before Flop (didn't bet)
Seat 6: win4dwddalways (small blind) collected ($6)


PokerStars Hand #232991723867:  Hold'em No Limit ($1/$2 USD) - 2022/01/16 10:58:00 ET
Table 'Atalante' 6-max Seat #6 is the button
Seat 1: iknewyouhadit ($203 in chips)
Seat 2: HHnguyen15 ($66.11 in chips)
Seat 3: pizzadad9 ($200 in chips)
Seat 4: MiltonBradley ($332.82 in chips)
Seat 5: Pierson2323 ($453.53 in chips)
Seat 6: win4dwddalways ($219.51 in chips)
iknewyouhadit: posts small blind $1
HHnguyen15: posts big blind $2
*** HOLE CARDS ***
pizzadad9: folds
MiltonBradley: raises $2.42 to $4.42
Pierson2323: calls $4.42
win4dwddalways: calls $4.42
iknewyouhadit: folds
HHnguyen15: folds
*** FLOP *** [Ad 3d 4c]
MiltonBradley: checks
Pierson2323: checks
win4dwddalways: bets $7.72
MiltonBradley: calls $7.72
Pierson2323: folds
*** TURN *** [Ad 3d 4c] [6h]
MiltonBradley: checks
win4dwddalways: checks
*** RIVER *** [Ad 3d 4c 6h] [4h]
MiltonBradley: checks
win4dwddalways: bets $22
MiltonBradley: folds
Uncalled bet ($22) returned to win4dwddalways
win4dwddalways collected $30.12 from pot
win4dwddalways: doesn't show hand
*** SUMMARY ***
Total pot $31.70 | Rake $1.58
Board [Ad 3d 4c 6h 4h]
Seat 1: iknewyouhadit (small blind) folded before Flop
Seat 2: HHnguyen15 (big blind) folded before Flop
Seat 3: pizzadad9 folded before Flop (didn't bet)
Seat 4: MiltonBradley folded on the River
Seat 5: Pierson2323 folded on the Flop
Seat 6: win4dwddalways (button) collected ($30.12)


PokerStars Hand #232991724190:  Hold'em No Limit ($1/$2 USD) - 2022/01/16 10:59:13 ET
Table 'Atalante' 6-max Seat #1 is the button
Seat 1: iknewyouhadit ($202 in chips)
Seat 2: HHnguyen15 ($64.11 in chips)
Seat 3: pizzadad9 ($200 in chips)
Seat 4: MiltonBradley ($320.68 in chips)
Seat 5: Pierson2323 ($449.11 in chips)
Seat 6: win4dwddalways ($237.49 in chips)
HHnguyen15: posts small blind $1
pizzadad9: posts big blind $2
*** HOLE CARDS ***
MiltonBradley: raises $4 to $6
Pierson2323: calls $6
win4dwddalways: folds
iknewyouhadit: folds
HHnguyen15: folds
pizzadad9: calls $4
*** FLOP *** [4s Qd 2c]
pizzadad9: checks
MiltonBradley: bets $9.39
Pierson2323: folds
pizzadad9: folds
Uncalled bet ($9.39) returned to MiltonBradley
MiltonBradley collected $18.05 from pot
MiltonBradley: doesn't show hand
*** SUMMARY ***
Total pot $19 | Rake $0.95
Board [4s Qd 2c]
Seat 1: iknewyouhadit (button) folded before Flop (didn't bet)
Seat 2: HHnguyen15 (small blind) folded before Flop
Seat 3: pizzadad9 (big blind) folded on the Flop
Seat 4: MiltonBradley collected ($18.05)
Seat 5: Pierson2323 folded on the Flop
Seat 6: win4dwddalways folded before Flop (didn't bet)


PokerStars Hand #232991724337:  Hold'em No Limit ($1/$2 USD) - 2022/01/16 10:59:48 ET
Table 'Atalante' 6-max Seat #2 is the button
Seat 1: iknewyouhadit ($202 in chips)
Seat 2: HHnguyen15 ($63.11 in chips)
Seat 3: pizzadad9 ($200 in chips)
Seat 4: MiltonBradley ($332.73 in chips)
Seat 5: Pierson2323 ($443.11 in chips)
Seat 6: win4dwddalways ($237.49 in chips)
pizzadad9: posts small blind $1
MiltonBradley: posts big blind $2
*** HOLE CARDS ***
Pierson2323: folds
win4dwddalways: folds
iknewyouhadit: folds
HHnguyen15: calls $2
pizzadad9: folds
MiltonBradley: checks
*** FLOP *** [6s Ks Tc]
MiltonBradley: checks
HHnguyen15: checks
*** TURN *** [6s Ks Tc] [Js]
MiltonBradley: checks
HHnguyen15: bets $4.75
MiltonBradley: folds
Uncalled bet ($4.75) returned to HHnguyen15
HHnguyen15 collected $4.75 from pot
HHnguyen15: doesn't show hand
*** SUMMARY ***
Total pot $5 | Rake $0.25
Board [6s Ks Tc Js]
Seat 1: iknewyouhadit folded before Flop (didn't bet)
Seat 2: HHnguyen15 (button) collected ($4.75)
Seat 3: pizzadad9 (small blind) folded before Flop
Seat 4: MiltonBradley (big blind) folded on the Turn
Seat 5: Pierson2323 folded before Flop (didn't bet)
Seat 6: win4dwddalways folded before Flop (didn't bet)


PokerStars Hand #232991724700:  Hold'em No Limit ($1/$2 USD) - 2022/01/16 11:01:05 ET
Table 'Atalante' 6-max Seat #4 is the button
Seat 1: iknewyouhadit ($202 in chips)
Seat 2: HHnguyen15 ($57.86 in chips)
Seat 3: pizzadad9 ($200 in chips)
Seat 4: MiltonBradley ($329.73 in chips)
Seat 5: Pierson2323 ($465.92 in chips)
Seat 6: win4dwddalways ($237.49 in chips)
Pierson2323: posts small blind $1
win4dwddalways: posts big blind $2
*** HOLE CARDS ***
iknewyouhadit: folds
HHnguyen15: folds
pizzadad9: folds
MiltonBradley: folds
Pierson2323: folds
Uncalled bet ($1) returned to win4dwddalways
win4dwddalways collected $2 from pot
win4dwddalways: doesn't show hand
*** SUMMARY ***
Total pot $2 | Rake $0
Seat 1: iknewyouhadit folded before Flop (didn't bet)
Seat 2: HHnguyen15 folded before Flop (didn't bet)
Seat 3: pizzadad9 folded before Flop (didn't bet)
Seat 4: MiltonBradley (button) folded before Flop (didn't bet)
Seat 5: Pierson2323 (small blind) folded before Flop
Seat 6: win4dwddalways (big blind) collected ($2)


PokerStars Hand #232991724440:  Hold'em No Limit ($1/$2 USD) - 2022/01/16 11:00:09 ET
Table 'Atalante' 6-max Seat #3 is the button
Seat 1: iknewyouhadit ($202 in chips)
Seat 2: HHnguyen15 ($65.86 in chips)
Seat 3: pizzadad9 ($200 in chips)
Seat 4: MiltonBradley ($330.73 in chips)
Seat 5: Pierson2323 ($443.11 in chips)
Seat 6: win4dwddalways ($237.49 in chips)
MiltonBradley: posts small blind $1
Pierson2323: posts big blind $2
*** HOLE CARDS ***
win4dwddalways: folds
iknewyouhadit: folds
HHnguyen15: calls $2
pizzadad9: raises $6 to $8
MiltonBradley: folds
Pierson2323: calls $6
HHnguyen15: calls $6
*** FLOP *** [2d Td 4d]
Pierson2323: checks
HHnguyen15: checks
pizzadad9: bets $7.84
Pierson2323: calls $7.84
HHnguyen15: folds
*** TURN *** [2d Td 4d] [Jh]
Pierson2323: checks
pizzadad9: checks
*** RIVER *** [2d Td 4d Jh] [Jd]
Pierson2323: bets $30
pizzadad9: folds
Uncalled bet ($30) returned to Pierson2323
Pierson2323 collected $38.65 from pot
*** SUMMARY ***
Total pot $40.68 | Rake $2.03
Board [2d Td 4d Jh Jd]
Seat 1: iknewyouhadit folded before Flop (didn't bet)
Seat 2: HHnguyen15 folded on the Flop
Seat 3: pizzadad9 (button) folded on the River
Seat 4: MiltonBradley (small blind) folded before Flop
Seat 5: Pierson2323 (big blind) collected ($38.65)
Seat 6: win4dwddalways folded before Flop (didn't bet)


PokerStars Hand #232991724877:  Hold'em No Limit ($1/$2 USD) - 2022/01/16 11:01:47 ET
Table 'Atalante' 6-max Seat #6 is the button
Seat 1: iknewyouhadit ($200 in chips)
Seat 2: HHnguyen15 ($74.55 in chips)
Seat 3: pizzadad9 ($200 in chips)
Seat 4: MiltonBradley ($314.35 in chips)
Seat 5: Pierson2323 ($464.92 in chips)
Seat 6: win4dwddalways ($237.49 in chips)
iknewyouhadit: posts small blind $1
HHnguyen15: posts big blind $2
*** HOLE CARDS ***
pizzadad9: folds
MiltonBradley: folds
Pierson2323: folds
win4dwddalways: folds
iknewyouhadit: folds
Uncalled bet ($1) returned to HHnguyen15
HHnguyen15 collected $2 from pot
HHnguyen15: doesn't show hand
*** SUMMARY ***
Total pot $2 | Rake $0
Seat 1: iknewyouhadit (small blind) folded before Flop
Seat 2: HHnguyen15 (big blind) collected ($2)
Seat 3: pizzadad9 folded before Flop (didn't bet)
Seat 4: MiltonBradley folded before Flop (didn't bet)
Seat 5: Pierson2323 folded before Flop (didn't bet)
Seat 6: win4dwddalways (button) folded before Flop (didn't bet)


PokerStars Hand #232991724739:  Hold'em No Limit ($1/$2 USD) - 2022/01/16 11:01:14 ET
Table 'Atalante' 6-max Seat #5 is the button
Seat 1: iknewyouhadit ($202 in chips)
Seat 2: HHnguyen15 ($57.86 in chips)
Seat 3: pizzadad9 ($200 in chips)
Seat 4: MiltonBradley ($329.73 in chips)
Seat 5: Pierson2323 ($464.92 in chips)
Seat 6: win4dwddalways ($238.49 in chips)
win4dwddalways: posts small blind $1
iknewyouhadit: posts big blind $2
*** HOLE CARDS ***
HHnguyen15: calls $2
pizzadad9: folds
MiltonBradley: raises $7 to $9
Pierson2323: folds
win4dwddalways: folds
iknewyouhadit: folds
HHnguyen15: calls $7
*** FLOP *** [Kc 8d 5s]
HHnguyen15: checks
MiltonBradley: bets $6.38
HHnguyen15: calls $6.38
*** TURN *** [Kc 8d 5s] [2h]
HHnguyen15: checks
MiltonBradley: checks
*** RIVER *** [Kc 8d 5s 2h] [3d]
HHnguyen15: checks
MiltonBradley: checks
*** SHOW DOWN ***
HHnguyen15: shows [6s 8c] (a pair of Eights)
MiltonBradley: mucks hand
HHnguyen15 collected $32.07 from pot
*** SUMMARY ***
Total pot $33.76 | Rake $1.69
Board [Kc 8d 5s 2h 3d]
Seat 1: iknewyouhadit (big blind) folded before Flop
Seat 2: HHnguyen15 showed [6s 8c] and won ($32.07) with a pair of Eights
Seat 3: pizzadad9 folded before Flop (didn't bet)
Seat 4: MiltonBradley mucked
Seat 5: Pierson2323 (button) folded before Flop (didn't bet)
Seat 6: win4dwddalways (small blind) folded before Flop


PokerStars Hand #232991724912:  Hold'em No Limit ($1/$2 USD) - 2022/01/16 11:01:54 ET
Table 'Atalante' 6-max Seat #1 is the button
Seat 1: iknewyouhadit ($200 in chips)
Seat 2: HHnguyen15 ($75.55 in chips)
Seat 4: MiltonBradley ($314.35 in chips)
Seat 5: Pierson2323 ($464.92 in chips)
Seat 6: win4dwddalways ($237.49 in chips)
HHnguyen15: posts small blind $1
pizzadad9: is sitting out
pizzadad9 leaves the table
MiltonBradley: posts big blind $2
*** HOLE CARDS ***
Pierson2323: folds
win4dwddalways: folds
iknewyouhadit: folds
HHnguyen15: calls $1
MiltonBradley: checks
*** FLOP *** [9c 3d 5d]
HHnguyen15: checks
MiltonBradley: checks
*** TURN *** [9c 3d 5d] [Qs]
HHnguyen15: checks
MiltonBradley: checks
*** RIVER *** [9c 3d 5d Qs] [Ks]
HHnguyen15: checks
MiltonBradley: checks
*** SHOW DOWN ***
HHnguyen15: shows [4d As] (high card Ace)
MiltonBradley: mucks hand
HHnguyen15 collected $3.80 from pot
*** SUMMARY ***
Total pot $4 | Rake $0.20
Board [9c 3d 5d Qs Ks]
Seat 1: iknewyouhadit (button) folded before Flop (didn't bet)
Seat 2: HHnguyen15 (small blind) showed [4d As] and won ($3.80) with high card Ace
Seat 4: MiltonBradley (big blind) mucked
Seat 5: Pierson2323 folded before Flop (didn't bet)
Seat 6: win4dwddalways folded before Flop (didn't bet)


PokerStars Hand #232991725007:  Hold'em No Limit ($1/$2 USD) - 2022/01/16 11:02:14 ET
Table 'Atalante' 6-max Seat #2 is the button
Seat 1: iknewyouhadit ($200 in chips)
Seat 2: HHnguyen15 ($77.35 in chips)
Seat 4: MiltonBradley ($312.35 in chips)
Seat 5: Pierson2323 ($464.92 in chips)
Seat 6: win4dwddalways ($237.49 in chips)
MiltonBradley: posts small blind $1
Pierson2323: posts big blind $2
*** HOLE CARDS ***
win4dwddalways: folds
iknewyouhadit: folds
HHnguyen15: calls $2
MiltonBradley: raises $7 to $9
Pierson2323: folds
HHnguyen15: folds
Uncalled bet ($7) returned to MiltonBradley
MiltonBradley collected $6 from pot
MiltonBradley: doesn't show hand
*** SUMMARY ***
Total pot $6 | Rake $0
Seat 1: iknewyouhadit folded before Flop (didn't bet)
Seat 2: HHnguyen15 (button) folded before Flop
Seat 4: MiltonBradley (small blind) collected ($6)
Seat 5: Pierson2323 (big blind) folded before Flop
Seat 6: win4dwddalways folded before Flop (didn't bet)


PokerStars Hand #232991725134:  Hold'em No Limit ($1/$2 USD) - 2022/01/16 11:02:43 ET
Table 'Atalante' 6-max Seat #4 is the button
Seat 1: iknewyouhadit ($200 in chips)
Seat 2: HHnguyen15 ($75.35 in chips)
Seat 4: MiltonBradley ($316.35 in chips)
Seat 5: Pierson2323 ($462.92 in chips)
Seat 6: win4dwddalways ($237.49 in chips)
Pierson2323: posts small blind $1
win4dwddalways: posts big blind $2
*** HOLE CARDS ***
iknewyouhadit: folds
HHnguyen15: folds
MiltonBradley: folds
Pierson2323: folds
Uncalled bet ($1) returned to win4dwddalways
win4dwddalways collected $2 from pot
win4dwddalways: doesn't show hand
*** SUMMARY ***
Total pot $2 | Rake $0
Seat 1: iknewyouhadit folded before Flop (didn't bet)
Seat 2: HHnguyen15 folded before Flop (didn't bet)
Seat 4: MiltonBradley (button) folded before Flop (didn't bet)
Seat 5: Pierson2323 (small blind) folded before Flop
Seat 6: win4dwddalways (big blind) collected ($2)


PokerStars Hand #232991725185:  Hold'em No Limit ($1/$2 USD) - 2022/01/16 11:02:53 ET
Table 'Atalante' 6-max Seat #5 is the button
Seat 1: iknewyouhadit ($200 in chips)
Seat 2: HHnguyen15 ($75.35 in chips)
Seat 4: MiltonBradley ($316.35 in chips)
Seat 5: Pierson2323 ($461.92 in chips)
Seat 6: win4dwddalways ($238.49 in chips)
win4dwddalways: posts small blind $1
iknewyouhadit: posts big blind $2
*** HOLE CARDS ***
HHnguyen15: calls $2
MiltonBradley: folds
Pierson2323: raises $4 to $6
win4dwddalways: folds
iknewyouhadit: folds
HHnguyen15: calls $4
*** FLOP *** [Ah 7c 9s]
HHnguyen15: checks
Pierson2323: bets $4
HHnguyen15: calls $4
*** TURN *** [Ah 7c 9s] [Kd]
HHnguyen15: checks
Pierson2323: checks
*** RIVER *** [Ah 7c 9s Kd] [6d]
HHnguyen15: checks
Pierson2323: bets $4
HHnguyen15: folds
Uncalled bet ($4) returned to Pierson2323
Pierson2323 collected $21.85 from pot
*** SUMMARY ***
Total pot $23 | Rake $1.15
Board [Ah 7c 9s Kd 6d]
Seat 1: iknewyouhadit (big blind) folded before Flop
Seat 2: HHnguyen15 folded on the River
Seat 4: MiltonBradley folded before Flop (didn't bet)
Seat 5: Pierson2323 (button) collected ($21.85)
Seat 6: win4dwddalways (small blind) folded before Flop


PokerStars Hand #232991725294:  Hold'em No Limit ($1/$2 USD) - 2022/01/16 11:03:17 ET
Table 'Atalante' 6-max Seat #6 is the button
Seat 1: iknewyouhadit ($200 in chips)
Seat 2: HHnguyen15 ($65.35 in chips)
Seat 4: MiltonBradley ($316.35 in chips)
Seat 5: Pierson2323 ($473.77 in chips)
Seat 6: win4dwddalways ($237.49 in chips)
iknewyouhadit: posts small blind $1
HHnguyen15: posts big blind $2
*** HOLE CARDS ***
MiltonBradley: folds
Pierson2323: folds
win4dwddalways: raises $4 to $6
iknewyouhadit: folds
HHnguyen15: calls $4
*** FLOP *** [Th Kc 8h]
HHnguyen15: checks
win4dwddalways: bets $6.17
HHnguyen15: calls $6.17
*** TURN *** [Th Kc 8h] [9h]
HHnguyen15: checks
win4dwddalways: checks
*** RIVER *** [Th Kc 8h 9h] [Qh]
HHnguyen15: bets $53.18 and is all-in
win4dwddalways: folds
Uncalled bet ($53.18) returned to HHnguyen15
HHnguyen15 collected $24.07 from pot
HHnguyen15: doesn't show hand
*** SUMMARY ***
Total pot $25.34 | Rake $1.27
Board [Th Kc 8h 9h Qh]
Seat 1: iknewyouhadit (small blind) folded before Flop
Seat 2: HHnguyen15 (big blind) collected ($24.07)
Seat 4: MiltonBradley folded before Flop (didn't bet)
Seat 5: Pierson2323 folded before Flop (didn't bet)
Seat 6: win4dwddalways (button) folded on the River


PokerStars Hand #232991725482:  Hold'em No Limit ($1/$2 USD) - 2022/01/16 11:03:57 ET
Table 'Atalante' 6-max Seat #1 is the button
Seat 1: iknewyouhadit ($200 in chips)
Seat 2: HHnguyen15 ($77.25 in chips)
Seat 4: MiltonBradley ($316.35 in chips)
Seat 5: Pierson2323 ($473.77 in chips)
Seat 6: win4dwddalways ($225.32 in chips)
HHnguyen15: posts small blind $1
MiltonBradley: posts big blind $2
*** HOLE CARDS ***
Pierson2323: folds
win4dwddalways: raises $4 to $6
iknewyouhadit: folds
HHnguyen15: calls $5
MiltonBradley: folds
*** FLOP *** [Qc 7h Ks]
HHnguyen15: checks
win4dwddalways: checks
*** TURN *** [Qc 7h Ks] [Js]
HHnguyen15: checks
win4dwddalways: checks
*** RIVER *** [Qc 7h Ks Js] [6d]
HHnguyen15: checks
win4dwddalways: checks
*** SHOW DOWN ***
HHnguyen15: shows [5s 7d] (a pair of Sevens)
win4dwddalways: mucks hand
HHnguyen15 collected $13.30 from pot
*** SUMMARY ***
Total pot $14 | Rake $0.70
Board [Qc 7h Ks Js 6d]
Seat 1: iknewyouhadit (button) folded before Flop (didn't bet)
Seat 2: HHnguyen15 (small blind) showed [5s 7d] and won ($13.30) with a pair of Sevens
Seat 4: MiltonBradley (big blind) folded before Flop
Seat 5: Pierson2323 folded before Flop (didn't bet)
Seat 6: win4dwddalways mucked


PokerStars Hand #232991725562:  Hold'em No Limit ($1/$2 USD) - 2022/01/16 11:04:16 ET
Table 'Atalante' 6-max Seat #2 is the button
Seat 1: iknewyouhadit ($200 in chips)
Seat 2: HHnguyen15 ($84.55 in chips)
Seat 4: MiltonBradley ($314.35 in chips)
Seat 5: Pierson2323 ($473.77 in chips)
Seat 6: win4dwddalways ($219.32 in chips)
MiltonBradley: posts small blind $1
Pierson2323: posts big blind $2
*** HOLE CARDS ***
win4dwddalways: raises $4 to $6
iknewyouhadit: folds
HHnguyen15: folds
MiltonBradley: folds
Pierson2323: folds
Uncalled bet ($4) returned to win4dwddalways
win4dwddalways collected $5 from pot
win4dwddalways: doesn't show hand
*** SUMMARY ***
Total pot $5 | Rake $0
Seat 1: iknewyouhadit folded before Flop (didn't bet)
Seat 2: HHnguyen15 (button) folded before Flop (didn't bet)
Seat 4: MiltonBradley (small blind) folded before Flop
Seat 5: Pierson2323 (big blind) folded before Flop
Seat 6: win4dwddalways collected ($5)


PokerStars Hand #232991725645:  Hold'em No Limit ($1/$2 USD) - 2022/01/16 11:04:32 ET
Table 'Atalante' 6-max Seat #4 is the button
Seat 1: iknewyouhadit ($200 in chips)
Seat 2: HHnguyen15 ($84.55 in chips)
Seat 4: MiltonBradley ($313.35 in chips)
Seat 5: Pierson2323 ($471.77 in chips)
Seat 6: win4dwddalways ($222.32 in chips)
Pierson2323: posts small blind $1
win4dwddalways: posts big blind $2
*** HOLE CARDS ***
iknewyouhadit: folds
HHnguyen15: calls $2
MiltonBradley: folds
rkinney64 joins the table at seat #3
Pierson2323: raises $4 to $6
win4dwddalways: calls $4
HHnguyen15: calls $4
*** FLOP *** [5s 9s 8h]
Pierson2323: bets $6
win4dwddalways: raises $10.55 to $16.55
HHnguyen15: folds
Pierson2323: calls $10.55
*** TURN *** [5s 9s 8h] [Qs]
Pierson2323: checks
win4dwddalways: bets $18.27
Pierson2323: calls $18.27
*** RIVER *** [5s 9s 8h Qs] [Js]
Pierson2323: checks
win4dwddalways: bets $32
Pierson2323: calls $32
*** SHOW DOWN ***
win4dwddalways: shows [Ts Ks] (a straight flush, Nine to King)
Pierson2323: mucks hand
win4dwddalways collected $148.64 from pot
*** SUMMARY ***
Total pot $151.64 | Rake $3
Board [5s 9s 8h Qs Js]
Seat 1: iknewyouhadit folded before Flop (didn't bet)
Seat 2: HHnguyen15 folded on the Flop
Seat 4: MiltonBradley (button) folded before Flop (didn't bet)
Seat 5: Pierson2323 (small blind) mucked
Seat 6: win4dwddalways (big blind) showed [Ts Ks] and won ($148.64) with a straight flush, Nine to King


PokerStars Hand #232991725936:  Hold'em No Limit ($1/$2 USD) - 2022/01/16 11:05:34 ET
Table 'Atalante' 6-max Seat #5 is the button
Seat 1: iknewyouhadit ($200 in chips)
Seat 2: HHnguyen15 ($78.55 in chips)
Seat 3: rkinney64 ($160 in chips)
Seat 4: MiltonBradley ($313.35 in chips)
Seat 5: Pierson2323 ($398.95 in chips)
Seat 6: win4dwddalways ($298.14 in chips)
win4dwddalways: posts small blind $1
iknewyouhadit: posts big blind $2
rkinney64: posts big blind $2
*** HOLE CARDS ***
HHnguyen15: folds
rkinney64: checks
MiltonBradley: folds
Pierson2323: raises $6 to $8
win4dwddalways: calls $7
iknewyouhadit: folds
rkinney64: folds
*** FLOP *** [5s 9d Qh]
win4dwddalways: checks
Pierson2323: bets $8
win4dwddalways: calls $8
*** TURN *** [5s 9d Qh] [Ah]
win4dwddalways: checks
Pierson2323: checks
*** RIVER *** [5s 9d Qh Ah] [3d]
win4dwddalways: checks
Pierson2323: bets $10
win4dwddalways: calls $10
*** SHOW DOWN ***
Pierson2323: shows [Jh Qc] (a pair of Queens)
win4dwddalways: shows [Kc Qd] (a pair of Queens - Ace+King kicker)
win4dwddalways collected $53.20 from pot
*** SUMMARY ***
Total pot $56 | Rake $2.80
Board [5s 9d Qh Ah 3d]
Seat 1: iknewyouhadit (big blind) folded before Flop
Seat 2: HHnguyen15 folded before Flop (didn't bet)
Seat 3: rkinney64 folded before Flop (didn't bet)
Seat 4: MiltonBradley folded before Flop (didn't bet)
Seat 5: Pierson2323 (button) showed [Jh Qc] and lost with a pair of Queens
Seat 6: win4dwddalways (small blind) showed [Kc Qd] and won ($53.20) with a pair of Queens


PokerStars Hand #232991726136:  Hold'em No Limit ($1/$2 USD) - 2022/01/16 11:06:17 ET
Table 'Atalante' 6-max Seat #6 is the button
Seat 1: iknewyouhadit ($200 in chips)
Seat 2: HHnguyen15 ($78.55 in chips)
Seat 3: rkinney64 ($158 in chips)
Seat 4: MiltonBradley ($313.35 in chips)
Seat 5: Pierson2323 ($372.95 in chips)
Seat 6: win4dwddalways ($325.34 in chips)
iknewyouhadit: posts small blind $1
HHnguyen15: posts big blind $2
*** HOLE CARDS ***
rkinney64: folds
MiltonBradley: folds
Pierson2323: raises $4 to $6
win4dwddalways: folds
iknewyouhadit: folds
HHnguyen15: calls $4
*** FLOP *** [Kh Ad 3s]
HHnguyen15: checks
Pierson2323: checks
*** TURN *** [Kh Ad 3s] [8d]
HHnguyen15: checks
Pierson2323: checks
*** RIVER *** [Kh Ad 3s 8d] [Qc]
HHnguyen15: checks
Pierson2323: checks
*** SHOW DOWN ***
HHnguyen15: shows [5d Td] (high card Ace)
Pierson2323: shows [7d 7s] (a pair of Sevens)
Pierson2323 collected $12.35 from pot
*** SUMMARY ***
Total pot $13 | Rake $0.65
Board [Kh Ad 3s 8d Qc]
Seat 1: iknewyouhadit (small blind) folded before Flop
Seat 2: HHnguyen15 (big blind) showed [5d Td] and lost with high card Ace
Seat 3: rkinney64 folded before Flop (didn't bet)
Seat 4: MiltonBradley folded before Flop (didn't bet)
Seat 5: Pierson2323 showed [7d 7s] and won ($12.35) with a pair of Sevens
Seat 6: win4dwddalways (button) folded before Flop (didn't bet)


PokerStars Hand #232991726292:  Hold'em No Limit ($1/$2 USD) - 2022/01/16 11:06:48 ET
Table 'Atalante' 6-max Seat #1 is the button
Seat 1: iknewyouhadit ($200 in chips)
Seat 2: HHnguyen15 ($72.55 in chips)
Seat 3: rkinney64 ($158 in chips)
Seat 4: MiltonBradley ($313.35 in chips)
Seat 5: Pierson2323 ($379.30 in chips)
Seat 6: win4dwddalways ($325.34 in chips)
HHnguyen15: posts small blind $1
rkinney64: posts big blind $2
*** HOLE CARDS ***
MiltonBradley: folds
Pierson2323: folds
win4dwddalways: folds
iknewyouhadit: raises $2.60 to $4.60
HHnguyen15: folds
rkinney64: folds
Uncalled bet ($2.60) returned to iknewyouhadit
iknewyouhadit collected $5 from pot
*** SUMMARY ***
Total pot $5 | Rake $0
Seat 1: iknewyouhadit (button) collected ($5)
Seat 2: HHnguyen15 (small blind) folded before Flop
Seat 3: rkinney64 (big blind) folded before Flop
Seat 4: MiltonBradley folded before Flop (didn't bet)
Seat 5: Pierson2323 folded before Flop (didn't bet)
Seat 6: win4dwddalways folded before Flop (didn't bet)


PokerStars Hand #232991726375:  Hold'em No Limit ($1/$2 USD) - 2022/01/16 11:07:03 ET
Table 'Atalante' 6-max Seat #2 is the button
Seat 1: iknewyouhadit ($203 in chips)
Seat 2: HHnguyen15 ($71.55 in chips)
Seat 3: rkinney64 ($156 in chips)
Seat 4: MiltonBradley ($313.35 in chips)
Seat 5: Pierson2323 ($379.30 in chips)
Seat 6: win4dwddalways ($325.34 in chips)
rkinney64: posts small blind $1
MiltonBradley: posts big blind $2
*** HOLE CARDS ***
Pierson2323: folds
win4dwddalways: folds
iknewyouhadit: raises $2.60 to $4.60
HHnguyen15: calls $4.60
rkinney64: folds
MiltonBradley: folds
*** FLOP *** [As 6s 5s]
iknewyouhadit: checks
HHnguyen15: checks
*** TURN *** [As 6s 5s] [2d]
iknewyouhadit: bets $5.80
HHnguyen15: folds
Uncalled bet ($5.80) returned to iknewyouhadit
iknewyouhadit collected $11.59 from pot
*** SUMMARY ***
Total pot $12.20 | Rake $0.61
Board [As 6s 5s 2d]
Seat 1: iknewyouhadit collected ($11.59)
Seat 2: HHnguyen15 (button) folded on the Turn
Seat 3: rkinney64 (small blind) folded before Flop
Seat 4: MiltonBradley (big blind) folded before Flop
Seat 5: Pierson2323 folded before Flop (didn't bet)
Seat 6: win4dwddalways folded before Flop (didn't bet)


PokerStars Hand #232991726519:  Hold'em No Limit ($1/$2 USD) - 2022/01/16 11:07:35 ET
Table 'Atalante' 6-max Seat #3 is the button
Seat 1: iknewyouhadit ($209.99 in chips)
Seat 2: HHnguyen15 ($66.95 in chips)
Seat 3: rkinney64 ($155 in chips)
Seat 4: MiltonBradley ($311.35 in chips)
Seat 5: Pierson2323 ($379.30 in chips)
Seat 6: win4dwddalways ($325.34 in chips)
MiltonBradley: posts small blind $1
Pierson2323: posts big blind $2
*** HOLE CARDS ***
win4dwddalways: folds
iknewyouhadit: folds
HHnguyen15: calls $2
rkinney64: folds
MiltonBradley: folds
Pierson2323: checks
*** FLOP *** [Kc 5h Tc]
Pierson2323: checks
HHnguyen15: checks
*** TURN *** [Kc 5h Tc] [Jc]
Pierson2323: bets $2
HHnguyen15: calls $2
*** RIVER *** [Kc 5h Tc Jc] [3c]
Pierson2323: checks
HHnguyen15: checks
*** SHOW DOWN ***
Pierson2323: shows [Ks 4d] (a pair of Kings)
HHnguyen15: shows [Ad 9c] (a flush, King high)
HHnguyen15 collected $8.55 from pot
*** SUMMARY ***
Total pot $9 | Rake $0.45
Board [Kc 5h Tc Jc 3c]
Seat 1: iknewyouhadit folded before Flop (didn't bet)
Seat 2: HHnguyen15 showed [Ad 9c] and won ($8.55) with a flush, King high
Seat 3: rkinney64 (button) folded before Flop (didn't bet)
Seat 4: MiltonBradley (small blind) folded before Flop
Seat 5: Pierson2323 (big blind) showed [Ks 4d] and lost with a pair of Kings
Seat 6: win4dwddalways folded before Flop (didn't bet)


PokerStars Hand #232991726677:  Hold'em No Limit ($1/$2 USD) - 2022/01/16 11:08:06 ET
Table 'Atalante' 6-max Seat #4 is the button
Seat 1: iknewyouhadit ($209.99 in chips)
Seat 2: HHnguyen15 ($71.50 in chips)
Seat 3: rkinney64 ($155 in chips)
Seat 4: MiltonBradley ($310.35 in chips)
Seat 5: Pierson2323 ($375.30 in chips)
Seat 6: win4dwddalways ($325.34 in chips)
Pierson2323: posts small blind $1
win4dwddalways: posts big blind $2
*** HOLE CARDS ***
iknewyouhadit: folds
HHnguyen15: calls $2
rkinney64: folds
MiltonBradley: folds
Pierson2323: folds
win4dwddalways: checks
*** FLOP *** [6h Ks Ad]
win4dwddalways: checks
HHnguyen15: checks
*** TURN *** [6h Ks Ad] [Qc]
win4dwddalways: checks
HHnguyen15: checks
*** RIVER *** [6h Ks Ad Qc] [5s]
win4dwddalways: checks
HHnguyen15: bets $4.75
win4dwddalways: folds
Uncalled bet ($4.75) returned to HHnguyen15
HHnguyen15 collected $4.75 from pot
HHnguyen15: doesn't show hand
*** SUMMARY ***
Total pot $5 | Rake $0.25
Board [6h Ks Ad Qc 5s]
Seat 1: iknewyouhadit folded before Flop (didn't bet)
Seat 2: HHnguyen15 collected ($4.75)
Seat 3: rkinney64 folded before Flop (didn't bet)
Seat 4: MiltonBradley (button) folded before Flop (didn't bet)
Seat 5: Pierson2323 (small blind) folded before Flop
Seat 6: win4dwddalways (big blind) folded on the River


PokerStars Hand #232991726783:  Hold'em No Limit ($1/$2 USD) - 2022/01/16 11:08:28 ET
Table 'Atalante' 6-max Seat #5 is the button
Seat 1: iknewyouhadit ($209.99 in chips)
Seat 2: HHnguyen15 ($74.25 in chips)
Seat 3: rkinney64 ($155 in chips)
Seat 4: MiltonBradley ($310.35 in chips)
Seat 5: Pierson2323 ($374.30 in chips)
Seat 6: win4dwddalways ($323.34 in chips)
win4dwddalways: posts small blind $1
iknewyouhadit: posts big blind $2
*** HOLE CARDS ***
HHnguyen15: folds
rkinney64: folds
MiltonBradley: folds
Pierson2323: folds
win4dwddalways: raises $4 to $6
iknewyouhadit: raises $12 to $18
win4dwddalways: calls $12
*** FLOP *** [7c Tc 8d]
win4dwddalways: checks
iknewyouhadit: checks
*** TURN *** [7c Tc 8d] [Jc]
win4dwddalways: bets $17.10
iknewyouhadit: folds
Uncalled bet ($17.10) returned to win4dwddalways
win4dwddalways collected $34.20 from pot
win4dwddalways: doesn't show hand
*** SUMMARY ***
Total pot $36 | Rake $1.80
Board [7c Tc 8d Jc]
Seat 1: iknewyouhadit (big blind) folded on the Turn
Seat 2: HHnguyen15 folded before Flop (didn't bet)
Seat 3: rkinney64 folded before Flop (didn't bet)
Seat 4: MiltonBradley folded before Flop (didn't bet)
Seat 5: Pierson2323 (button) folded before Flop (didn't bet)
Seat 6: win4dwddalways (small blind) collected ($34.20)


PokerStars Hand #232991727111:  Hold'em No Limit ($1/$2 USD) - 2022/01/16 11:09:35 ET
Table 'Atalante' 6-max Seat #6 is the button
Seat 1: iknewyouhadit ($200 in chips)
Seat 2: HHnguyen15 ($74.25 in chips)
Seat 3: rkinney64 ($155 in chips)
Seat 4: MiltonBradley ($310.35 in chips)
Seat 5: Pierson2323 ($374.30 in chips)
Seat 6: win4dwddalways ($339.54 in chips)
iknewyouhadit: posts small blind $1
HHnguyen15: posts big blind $2
*** HOLE CARDS ***
rkinney64: raises $4 to $6
MiltonBradley: folds
Pierson2323: folds
win4dwddalways: calls $6
iknewyouhadit: folds
HHnguyen15: folds
*** FLOP *** [Js Ad 9h]
rkinney64: checks
win4dwddalways: checks
*** TURN *** [Js Ad 9h] [6d]
rkinney64: checks
win4dwddalways: bets $7.12
rkinney64: calls $7.12
*** RIVER *** [Js Ad 9h 6d] [Qs]
rkinney64: checks
win4dwddalways: checks
*** SHOW DOWN ***
rkinney64: shows [Qc Qh] (three of a kind, Queens)
win4dwddalways: mucks hand
rkinney64 collected $27.78 from pot
*** SUMMARY ***
Total pot $29.24 | Rake $1.46
Board [Js Ad 9h 6d Qs]
Seat 1: iknewyouhadit (small blind) folded before Flop
Seat 2: HHnguyen15 (big blind) folded before Flop
Seat 3: rkinney64 showed [Qc Qh] and won ($27.78) with three of a kind, Queens
Seat 4: MiltonBradley folded before Flop (didn't bet)
Seat 5: Pierson2323 folded before Flop (didn't bet)
Seat 6: win4dwddalways (button) mucked


PokerStars Hand #232991727288:  Hold'em No Limit ($1/$2 USD) - 2022/01/16 11:10:14 ET
Table 'Atalante' 6-max Seat #1 is the button
Seat 1: iknewyouhadit ($200 in chips)
Seat 2: HHnguyen15 ($72.25 in chips)
Seat 3: rkinney64 ($169.66 in chips)
Seat 4: MiltonBradley ($310.35 in chips)
Seat 5: Pierson2323 ($374.30 in chips)
Seat 6: win4dwddalways ($326.42 in chips)
HHnguyen15: posts small blind $1
rkinney64: posts big blind $2
*** HOLE CARDS ***
MiltonBradley: folds
Pierson2323: folds
win4dwddalways: folds
iknewyouhadit: folds
HHnguyen15: folds
Uncalled bet ($1) returned to rkinney64
rkinney64 collected $2 from pot
rkinney64: doesn't show hand
*** SUMMARY ***
Total pot $2 | Rake $0
Seat 1: iknewyouhadit (button) folded before Flop (didn't bet)
Seat 2: HHnguyen15 (small blind) folded before Flop
Seat 3: rkinney64 (big blind) collected ($2)
Seat 4: MiltonBradley folded before Flop (didn't bet)
Seat 5: Pierson2323 folded before Flop (didn't bet)
Seat 6: win4dwddalways folded before Flop (didn't bet)


PokerStars Hand #232991727367:  Hold'em No Limit ($1/$2 USD) - 2022/01/16 11:10:29 ET
Table 'Atalante' 6-max Seat #2 is the button
Seat 1: iknewyouhadit ($200 in chips)
Seat 2: HHnguyen15 ($71.25 in chips)
Seat 3: rkinney64 ($170.66 in chips)
Seat 4: MiltonBradley ($310.35 in chips)
Seat 5: Pierson2323 ($374.30 in chips)
Seat 6: win4dwddalways ($326.42 in chips)
rkinney64: posts small blind $1
MiltonBradley: posts big blind $2
*** HOLE CARDS ***
Pierson2323: raises $4 to $6
win4dwddalways: folds
iknewyouhadit: folds
HHnguyen15: calls $6
rkinney64: folds
MiltonBradley: folds
*** FLOP *** [4s Qs Ah]
Pierson2323: bets $4.99
HHnguyen15: folds
Uncalled bet ($4.99) returned to Pierson2323
Pierson2323 collected $14.25 from pot
Pierson2323: doesn't show hand
*** SUMMARY ***
Total pot $15 | Rake $0.75
Board [4s Qs Ah]
Seat 1: iknewyouhadit folded before Flop (didn't bet)
Seat 2: HHnguyen15 (button) folded on the Flop
Seat 3: rkinney64 (small blind) folded before Flop
Seat 4: MiltonBradley (big blind) folded before Flop
Seat 5: Pierson2323 collected ($14.25)
Seat 6: win4dwddalways folded before Flop (didn't bet)


PokerStars Hand #232991727483:  Hold'em No Limit ($1/$2 USD) - 2022/01/16 11:10:53 ET
Table 'Atalante' 6-max Seat #3 is the button
Seat 1: iknewyouhadit ($200 in chips)
Seat 2: HHnguyen15 ($65.25 in chips)
Seat 3: rkinney64 ($169.66 in chips)
Seat 4: MiltonBradley ($308.35 in chips)
Seat 5: Pierson2323 ($382.55 in chips)
Seat 6: win4dwddalways ($326.42 in chips)
MiltonBradley: posts small blind $1
Pierson2323: posts big blind $2
*** HOLE CARDS ***
win4dwddalways: folds
iknewyouhadit: folds
HHnguyen15: raises $4 to $6
rkinney64: calls $6
MiltonBradley: folds
Pierson2323: calls $4
*** FLOP *** [Qd 5s 6d]
Pierson2323: checks
HHnguyen15: bets $59.25 and is all-in
rkinney64: calls $59.25
Pierson2323: folds
*** TURN *** [Qd 5s 6d] [3d]
*** RIVER *** [Qd 5s 6d 3d] [Ah]
*** SHOW DOWN ***
HHnguyen15: shows [Qc Ad] (two pair, Aces and Queens)
rkinney64: shows [5d 5h] (three of a kind, Fives)
rkinney64 collected $134.50 from pot
*** SUMMARY ***
Total pot $137.50 | Rake $3
Board [Qd 5s 6d 3d Ah]
Seat 1: iknewyouhadit folded before Flop (didn't bet)
Seat 2: HHnguyen15 showed [Qc Ad] and lost with two pair, Aces and Queens
Seat 3: rkinney64 (button) showed [5d 5h] and won ($134.50) with three of a kind, Fives
Seat 4: MiltonBradley (small blind) folded before Flop
Seat 5: Pierson2323 (big blind) folded on the Flop
Seat 6: win4dwddalways folded before Flop (didn't bet)


PokerStars Hand #232991727694:  Hold'em No Limit ($1/$2 USD) - 2022/01/16 11:11:34 ET
Table 'Atalante' 6-max Seat #4 is the button
Seat 1: iknewyouhadit ($200 in chips)
Seat 3: rkinney64 ($238.91 in chips)
Seat 4: MiltonBradley ($307.35 in chips)
Seat 5: Pierson2323 ($376.55 in chips)
Seat 6: win4dwddalways ($326.42 in chips)
Pierson2323: posts small blind $1
win4dwddalways: posts big blind $2
*** HOLE CARDS ***
iknewyouhadit: folds
rkinney64: folds
HHnguyen15 leaves the table
CharlieM84 joins the table at seat #2
MiltonBradley: folds
Pierson2323: folds
Uncalled bet ($1) returned to win4dwddalways
win4dwddalways collected $2 from pot
win4dwddalways: doesn't show hand
*** SUMMARY ***
Total pot $2 | Rake $0
Seat 1: iknewyouhadit folded before Flop (didn't bet)
Seat 3: rkinney64 folded before Flop (didn't bet)
Seat 4: MiltonBradley (button) folded before Flop (didn't bet)
Seat 5: Pierson2323 (small blind) folded before Flop
Seat 6: win4dwddalways (big blind) collected ($2)


PokerStars Hand #232991727807:  Hold'em No Limit ($1/$2 USD) - 2022/01/16 11:11:54 ET
Table 'Atalante' 6-max Seat #5 is the button
Seat 1: iknewyouhadit ($200 in chips)
Seat 3: rkinney64 ($238.91 in chips)
Seat 4: MiltonBradley ($307.35 in chips)
Seat 5: Pierson2323 ($375.55 in chips)
Seat 6: win4dwddalways ($327.42 in chips)
win4dwddalways: posts small blind $1
iknewyouhadit: posts big blind $2
CharlieM84: sits out
*** HOLE CARDS ***
rkinney64: folds
MiltonBradley: folds
Pierson2323: folds
win4dwddalways: folds
Uncalled bet ($1) returned to iknewyouhadit
iknewyouhadit collected $2 from pot
*** SUMMARY ***
Total pot $2 | Rake $0
Seat 1: iknewyouhadit (big blind) collected ($2)
Seat 3: rkinney64 folded before Flop (didn't bet)
Seat 4: MiltonBradley folded before Flop (didn't bet)
Seat 5: Pierson2323 (button) folded before Flop (didn't bet)
Seat 6: win4dwddalways (small blind) folded before Flop


PokerStars Hand #232991727970:  Hold'em No Limit ($1/$2 USD) - 2022/01/16 11:12:28 ET
Table 'Atalante' 6-max Seat #6 is the button
Seat 1: iknewyouhadit ($201 in chips)
Seat 2: CharlieM84 ($200 in chips)
Seat 3: rkinney64 ($238.91 in chips)
Seat 4: MiltonBradley ($307.35 in chips)
Seat 5: Pierson2323 ($375.55 in chips)
Seat 6: win4dwddalways ($326.42 in chips)
iknewyouhadit: posts small blind $1
CharlieM84: posts big blind $2
*** HOLE CARDS ***
rkinney64: raises $4 to $6
MiltonBradley: folds
Pierson2323: calls $6
win4dwddalways: calls $6
iknewyouhadit: folds
CharlieM84: folds
*** FLOP *** [Ac 6h Jc]
rkinney64: checks
Pierson2323: checks
win4dwddalways: bets $9.97
rkinney64: folds
Pierson2323: calls $9.97
*** TURN *** [Ac 6h Jc] [2h]
Pierson2323: checks
win4dwddalways: checks
*** RIVER *** [Ac 6h Jc 2h] [6d]
Pierson2323: checks
win4dwddalways: checks
*** SHOW DOWN ***
Pierson2323: shows [Js Qs] (two pair, Jacks and Sixes)
win4dwddalways: mucks hand
Pierson2323 collected $38.89 from pot
*** SUMMARY ***
Total pot $40.94 | Rake $2.05
Board [Ac 6h Jc 2h 6d]
Seat 1: iknewyouhadit (small blind) folded before Flop
Seat 2: CharlieM84 (big blind) folded before Flop
Seat 3: rkinney64 folded on the Flop
Seat 4: MiltonBradley folded before Flop (didn't bet)
Seat 5: Pierson2323 showed [Js Qs] and won ($38.89) with two pair, Jacks and Sixes
Seat 6: win4dwddalways (button) mucked


PokerStars Hand #232991728301:  Hold'em No Limit ($1/$2 USD) - 2022/01/16 11:13:45 ET
Table 'Atalante' 6-max Seat #1 is the button
Seat 1: iknewyouhadit ($200 in chips)
Seat 2: CharlieM84 ($200 in chips)
Seat 3: rkinney64 ($232.91 in chips)
Seat 4: MiltonBradley ($307.35 in chips)
Seat 5: Pierson2323 ($398.47 in chips)
Seat 6: win4dwddalways ($310.45 in chips)
CharlieM84: posts small blind $1
rkinney64: posts big blind $2
*** HOLE CARDS ***
MiltonBradley: folds
Pierson2323: folds
win4dwddalways: folds
iknewyouhadit: raises $2.60 to $4.60
CharlieM84: folds
rkinney64: folds
Uncalled bet ($2.60) returned to iknewyouhadit
iknewyouhadit collected $5 from pot
*** SUMMARY ***
Total pot $5 | Rake $0
Seat 1: iknewyouhadit (button) collected ($5)
Seat 2: CharlieM84 (small blind) folded before Flop
Seat 3: rkinney64 (big blind) folded before Flop
Seat 4: MiltonBradley folded before Flop (didn't bet)
Seat 5: Pierson2323 folded before Flop (didn't bet)
Seat 6: win4dwddalways folded before Flop (didn't bet)


PokerStars Hand #232991728393:  Hold'em No Limit ($1/$2 USD) - 2022/01/16 11:14:03 ET
Table 'Atalante' 6-max Seat #2 is the button
Seat 1: iknewyouhadit ($203 in chips)
Seat 2: CharlieM84 ($200 in chips)
Seat 3: rkinney64 ($230.91 in chips)
Seat 4: MiltonBradley ($307.35 in chips)
Seat 5: Pierson2323 ($398.47 in chips)
Seat 6: win4dwddalways ($310.45 in chips)
rkinney64: posts small blind $1
MiltonBradley: posts big blind $2
*** HOLE CARDS ***
Pierson2323: folds
win4dwddalways: folds
iknewyouhadit: folds
CharlieM84: raises $3 to $5
rkinney64: folds
MiltonBradley: folds
Uncalled bet ($3) returned to CharlieM84
CharlieM84 collected $5 from pot
CharlieM84: doesn't show hand
*** SUMMARY ***
Total pot $5 | Rake $0
Seat 1: iknewyouhadit folded before Flop (didn't bet)
Seat 2: CharlieM84 (button) collected ($5)
Seat 3: rkinney64 (small blind) folded before Flop
Seat 4: MiltonBradley (big blind) folded before Flop
Seat 5: Pierson2323 folded before Flop (didn't bet)
Seat 6: win4dwddalways folded before Flop (didn't bet)


PokerStars Hand #232991728452:  Hold'em No Limit ($1/$2 USD) - 2022/01/16 11:14:16 ET
Table 'Atalante' 6-max Seat #3 is the button
Seat 1: iknewyouhadit ($203 in chips)
Seat 2: CharlieM84 ($203 in chips)
Seat 3: rkinney64 ($229.91 in chips)
Seat 4: MiltonBradley ($305.35 in chips)
Seat 5: Pierson2323 ($398.47 in chips)
Seat 6: win4dwddalways ($310.45 in chips)
MiltonBradley: posts small blind $1
Pierson2323: posts big blind $2
*** HOLE CARDS ***
win4dwddalways: folds
iknewyouhadit: folds
CharlieM84: raises $3 to $5
rkinney64: folds
MiltonBradley: folds
Pierson2323: calls $3
*** FLOP *** [Ac 5s 3h]
Pierson2323: checks
CharlieM84: checks
*** TURN *** [Ac 5s 3h] [Tc]
Pierson2323: checks
CharlieM84: bets $7.84
Pierson2323: calls $7.84
*** RIVER *** [Ac 5s 3h Tc] [7s]
Pierson2323: checks
CharlieM84: checks
*** SHOW DOWN ***
Pierson2323: shows [Td 9d] (a pair of Tens)
CharlieM84: shows [Ah 2h] (a pair of Aces)
CharlieM84 collected $25.35 from pot
*** SUMMARY ***
Total pot $26.68 | Rake $1.33
Board [Ac 5s 3h Tc 7s]
Seat 1: iknewyouhadit folded before Flop (didn't bet)
Seat 2: CharlieM84 showed [Ah 2h] and won ($25.35) with a pair of Aces
Seat 3: rkinney64 (button) folded before Flop (didn't bet)
Seat 4: MiltonBradley (small blind) folded before Flop
Seat 5: Pierson2323 (big blind) showed [Td 9d] and lost with a pair of Tens
Seat 6: win4dwddalways folded before Flop (didn't bet)


PokerStars Hand #232991728638:  Hold'em No Limit ($1/$2 USD) - 2022/01/16 11:14:56 ET
Table 'Atalante' 6-max Seat #4 is the button
Seat 1: iknewyouhadit ($203 in chips)
Seat 2: CharlieM84 ($215.51 in chips)
Seat 3: rkinney64 ($229.91 in chips)
Seat 4: MiltonBradley ($304.35 in chips)
Seat 5: Pierson2323 ($385.63 in chips)
Seat 6: win4dwddalways ($310.45 in chips)
Pierson2323: posts small blind $1
win4dwddalways: posts big blind $2
*** HOLE CARDS ***
iknewyouhadit: folds
CharlieM84: folds
rkinney64: raises $2 to $4
MiltonBradley: folds
Pierson2323: folds
win4dwddalways: calls $2
*** FLOP *** [3s 5c Ks]
win4dwddalways: checks
rkinney64: checks
*** TURN *** [3s 5c Ks] [Th]
win4dwddalways: bets $4.27
rkinney64: folds
Uncalled bet ($4.27) returned to win4dwddalways
win4dwddalways collected $8.55 from pot
win4dwddalways: doesn't show hand
*** SUMMARY ***
Total pot $9 | Rake $0.45
Board [3s 5c Ks Th]
Seat 1: iknewyouhadit folded before Flop (didn't bet)
Seat 2: CharlieM84 folded before Flop (didn't bet)
Seat 3: rkinney64 folded on the Turn
Seat 4: MiltonBradley (button) folded before Flop (didn't bet)
Seat 5: Pierson2323 (small blind) folded before Flop
Seat 6: win4dwddalways (big blind) collected ($8.55)


PokerStars Hand #232991728819:  Hold'em No Limit ($1/$2 USD) - 2022/01/16 11:15:34 ET
Table 'Atalante' 6-max Seat #5 is the button
Seat 1: iknewyouhadit ($203 in chips)
Seat 2: CharlieM84 ($215.51 in chips)
Seat 3: rkinney64 ($225.91 in chips)
Seat 4: MiltonBradley ($304.35 in chips)
Seat 5: Pierson2323 ($384.63 in chips)
Seat 6: win4dwddalways ($315 in chips)
win4dwddalways: posts small blind $1
iknewyouhadit: posts big blind $2
*** HOLE CARDS ***
CharlieM84: folds
rkinney64: folds
MiltonBradley: raises $2.42 to $4.42
Pierson2323: folds
win4dwddalways: folds
iknewyouhadit: folds
Uncalled bet ($2.42) returned to MiltonBradley
MiltonBradley collected $5 from pot
MiltonBradley: doesn't show hand
*** SUMMARY ***
Total pot $5 | Rake $0
Seat 1: iknewyouhadit (big blind) folded before Flop
Seat 2: CharlieM84 folded before Flop (didn't bet)
Seat 3: rkinney64 folded before Flop (didn't bet)
Seat 4: MiltonBradley collected ($5)
Seat 5: Pierson2323 (button) folded before Flop (didn't bet)
Seat 6: win4dwddalways (small blind) folded before Flop


PokerStars Hand #232991728872:  Hold'em No Limit ($1/$2 USD) - 2022/01/16 11:15:47 ET
Table 'Atalante' 6-max Seat #6 is the button
Seat 1: iknewyouhadit ($201 in chips)
Seat 2: CharlieM84 ($215.51 in chips)
Seat 3: rkinney64 ($225.91 in chips)
Seat 4: MiltonBradley ($307.35 in chips)
Seat 5: Pierson2323 ($384.63 in chips)
Seat 6: win4dwddalways ($314 in chips)
iknewyouhadit: posts small blind $1
CharlieM84: posts big blind $2
*** HOLE CARDS ***
rkinney64: folds
MiltonBradley: folds
Pierson2323: folds
win4dwddalways: raises $4 to $6
iknewyouhadit: folds
CharlieM84: folds
Uncalled bet ($4) returned to win4dwddalways
win4dwddalways collected $5 from pot
win4dwddalways: doesn't show hand
*** SUMMARY ***
Total pot $5 | Rake $0
Seat 1: iknewyouhadit (small blind) folded before Flop
Seat 2: CharlieM84 (big blind) folded before Flop
Seat 3: rkinney64 folded before Flop (didn't bet)
Seat 4: MiltonBradley folded before Flop (didn't bet)
Seat 5: Pierson2323 folded before Flop (didn't bet)
Seat 6: win4dwddalways (button) collected ($5)


PokerStars Hand #232991728961:  Hold'em No Limit ($1/$2 USD) - 2022/01/16 11:16:07 ET
Table 'Atalante' 6-max Seat #1 is the button
Seat 1: iknewyouhadit ($200 in chips)
Seat 2: CharlieM84 ($213.51 in chips)
Seat 3: rkinney64 ($225.91 in chips)
Seat 4: MiltonBradley ($307.35 in chips)
Seat 5: Pierson2323 ($384.63 in chips)
Seat 6: win4dwddalways ($317 in chips)
CharlieM84: posts small blind $1
rkinney64: posts big blind $2
*** HOLE CARDS ***
MiltonBradley: folds
Pierson2323: folds
win4dwddalways: folds
iknewyouhadit: folds
CharlieM84: folds
Uncalled bet ($1) returned to rkinney64
rkinney64 collected $2 from pot
rkinney64: doesn't show hand
*** SUMMARY ***
Total pot $2 | Rake $0
Seat 1: iknewyouhadit (button) folded before Flop (didn't bet)
Seat 2: CharlieM84 (small blind) folded before Flop
Seat 3: rkinney64 (big blind) collected ($2)
Seat 4: MiltonBradley folded before Flop (didn't bet)
Seat 5: Pierson2323 folded before Flop (didn't bet)
Seat 6: win4dwddalways folded before Flop (didn't bet)


PokerStars Hand #232991729000:  Hold'em No Limit ($1/$2 USD) - 2022/01/16 11:16:16 ET
Table 'Atalante' 6-max Seat #2 is the button
Seat 1: iknewyouhadit ($200 in chips)
Seat 2: CharlieM84 ($212.51 in chips)
Seat 3: rkinney64 ($226.91 in chips)
Seat 4: MiltonBradley ($307.35 in chips)
Seat 5: Pierson2323 ($384.63 in chips)
Seat 6: win4dwddalways ($317 in chips)
rkinney64: posts small blind $1
MiltonBradley: posts big blind $2
*** HOLE CARDS ***
Pierson2323: raises $4 to $6
win4dwddalways: folds
iknewyouhadit: folds
CharlieM84: folds
rkinney64: folds
MiltonBradley: raises $16.90 to $22.90
Pierson2323: calls $16.90
*** FLOP *** [Kc 8c 6c]
MiltonBradley: checks
Pierson2323: checks
*** TURN *** [Kc 8c 6c] [7c]
MiltonBradley: checks
Pierson2323: bets $16
MiltonBradley: calls $16
*** RIVER *** [Kc 8c 6c 7c] [5h]
MiltonBradley: checks
Pierson2323: bets $100
MiltonBradley: folds
Uncalled bet ($100) returned to Pierson2323
Pierson2323 collected $75.80 from pot
*** SUMMARY ***
Total pot $78.80 | Rake $3
Board [Kc 8c 6c 7c 5h]
Seat 1: iknewyouhadit folded before Flop (didn't bet)
Seat 2: CharlieM84 (button) folded before Flop (didn't bet)
Seat 3: rkinney64 (small blind) folded before Flop
Seat 4: MiltonBradley (big blind) folded on the River
Seat 5: Pierson2323 collected ($75.80)
Seat 6: win4dwddalways folded before Flop (didn't bet)


PokerStars Hand #232991729212:  Hold'em No Limit ($1/$2 USD) - 2022/01/16 11:17:07 ET
Table 'Atalante' 6-max Seat #3 is the button
Seat 1: iknewyouhadit ($200 in chips)
Seat 2: CharlieM84 ($212.51 in chips)
Seat 3: rkinney64 ($225.91 in chips)
Seat 4: MiltonBradley ($268.45 in chips)
Seat 5: Pierson2323 ($421.53 in chips)
Seat 6: win4dwddalways ($317 in chips)
MiltonBradley: posts small blind $1
Pierson2323: posts big blind $2
*** HOLE CARDS ***
win4dwddalways: folds
iknewyouhadit: folds
CharlieM84: raises $3 to $5
rkinney64: folds
MiltonBradley: folds
Pierson2323: calls $3
*** FLOP *** [2h 9s 6h]
Pierson2323: checks
CharlieM84: checks
*** TURN *** [2h 9s 6h] [8h]
Pierson2323: bets $4
CharlieM84: folds
Uncalled bet ($4) returned to Pierson2323
Pierson2323 collected $10.45 from pot
*** SUMMARY ***
Total pot $11 | Rake $0.55
Board [2h 9s 6h 8h]
Seat 1: iknewyouhadit folded before Flop (didn't bet)
Seat 2: CharlieM84 folded on the Turn
Seat 3: rkinney64 (button) folded before Flop (didn't bet)
Seat 4: MiltonBradley (small blind) folded before Flop
Seat 5: Pierson2323 (big blind) collected ($10.45)
Seat 6: win4dwddalways folded before Flop (didn't bet)


PokerStars Hand #232991729358:  Hold'em No Limit ($1/$2 USD) - 2022/01/16 11:17:41 ET
Table 'Atalante' 6-max Seat #4 is the button
Seat 1: iknewyouhadit ($200 in chips)
Seat 2: CharlieM84 ($207.51 in chips)
Seat 3: rkinney64 ($225.91 in chips)
Seat 4: MiltonBradley ($267.45 in chips)
Seat 5: Pierson2323 ($426.98 in chips)
Seat 6: win4dwddalways ($317 in chips)
Pierson2323: posts small blind $1
win4dwddalways: posts big blind $2
*** HOLE CARDS ***
iknewyouhadit: folds
CharlieM84: folds
rkinney64: folds
MiltonBradley: folds
Pierson2323: folds
Uncalled bet ($1) returned to win4dwddalways
win4dwddalways collected $2 from pot
win4dwddalways: doesn't show hand
*** SUMMARY ***
Total pot $2 | Rake $0
Seat 1: iknewyouhadit folded before Flop (didn't bet)
Seat 2: CharlieM84 folded before Flop (didn't bet)
Seat 3: rkinney64 folded before Flop (didn't bet)
Seat 4: MiltonBradley (button) folded before Flop (didn't bet)
Seat 5: Pierson2323 (small blind) folded before Flop
Seat 6: win4dwddalways (big blind) collected ($2)


PokerStars Hand #232991729435:  Hold'em No Limit ($1/$2 USD) - 2022/01/16 11:17:59 ET
Table 'Atalante' 6-max Seat #5 is the button
Seat 1: iknewyouhadit ($200 in chips)
Seat 2: CharlieM84 ($207.51 in chips)
Seat 3: rkinney64 ($225.91 in chips)
Seat 4: MiltonBradley ($267.45 in chips)
Seat 5: Pierson2323 ($425.98 in chips)
Seat 6: win4dwddalways ($318 in chips)
win4dwddalways: posts small blind $1
iknewyouhadit: posts big blind $2
*** HOLE CARDS ***
CharlieM84: folds
rkinney64: calls $2
MiltonBradley: folds
Pierson2323: folds
win4dwddalways: folds
iknewyouhadit: checks
*** FLOP *** [4s Jd Kh]
iknewyouhadit: checks
rkinney64: bets $4
iknewyouhadit: folds
Uncalled bet ($4) returned to rkinney64
rkinney64 collected $4.75 from pot
rkinney64: doesn't show hand
*** SUMMARY ***
Total pot $5 | Rake $0.25
Board [4s Jd Kh]
Seat 1: iknewyouhadit (big blind) folded on the Flop
Seat 2: CharlieM84 folded before Flop (didn't bet)
Seat 3: rkinney64 collected ($4.75)
Seat 4: MiltonBradley folded before Flop (didn't bet)
Seat 5: Pierson2323 (button) folded before Flop (didn't bet)
Seat 6: win4dwddalways (small blind) folded before Flop


PokerStars Hand #232991729577:  Hold'em No Limit ($1/$2 USD) - 2022/01/16 11:18:30 ET
Table 'Atalante' 6-max Seat #6 is the button
Seat 1: iknewyouhadit ($200 in chips)
Seat 2: CharlieM84 ($207.51 in chips)
Seat 3: rkinney64 ($228.66 in chips)
Seat 4: MiltonBradley ($267.45 in chips)
Seat 5: Pierson2323 ($425.98 in chips)
Seat 6: win4dwddalways ($317 in chips)
iknewyouhadit: posts small blind $1
CharlieM84: posts big blind $2
*** HOLE CARDS ***
rkinney64: folds
MiltonBradley: folds
Pierson2323: raises $4 to $6
win4dwddalways: folds
iknewyouhadit: folds
CharlieM84: folds
Uncalled bet ($4) returned to Pierson2323
Pierson2323 collected $5 from pot
*** SUMMARY ***
Total pot $5 | Rake $0
Seat 1: iknewyouhadit (small blind) folded before Flop
Seat 2: CharlieM84 (big blind) folded before Flop
Seat 3: rkinney64 folded before Flop (didn't bet)
Seat 4: MiltonBradley folded before Flop (didn't bet)
Seat 5: Pierson2323 collected ($5)
Seat 6: win4dwddalways (button) folded before Flop (didn't bet)


PokerStars Hand #232991729688:  Hold'em No Limit ($1/$2 USD) - 2022/01/16 11:18:55 ET
Table 'Atalante' 6-max Seat #1 is the button
Seat 1: iknewyouhadit ($200 in chips)
Seat 2: CharlieM84 ($205.51 in chips)
Seat 3: rkinney64 ($228.66 in chips)
Seat 4: MiltonBradley ($267.45 in chips)
Seat 6: win4dwddalways ($317 in chips)
CharlieM84: posts small blind $1
rkinney64: posts big blind $2
*** HOLE CARDS ***
Pierson2323 leaves the table
MiltonBradley: folds
win4dwddalways: folds
iknewyouhadit: folds
CharlieM84: raises $4 to $6
rkinney64: calls $4
*** FLOP *** [Ts 8d 7s]
CharlieM84: bets $5.70
rkinney64: calls $5.70
*** TURN *** [Ts 8d 7s] [Tc]
CharlieM84: checks
rkinney64: bets $18
CharlieM84: folds
Uncalled bet ($18) returned to rkinney64
rkinney64 collected $22.23 from pot
rkinney64: doesn't show hand
*** SUMMARY ***
Total pot $23.40 | Rake $1.17
Board [Ts 8d 7s Tc]
Seat 1: iknewyouhadit (button) folded before Flop (didn't bet)
Seat 2: CharlieM84 (small blind) folded on the Turn
Seat 3: rkinney64 (big blind) collected ($22.23)
Seat 4: MiltonBradley folded before Flop (didn't bet)
Seat 6: win4dwddalways folded before Flop (didn't bet)


PokerStars Hand #232991729856:  Hold'em No Limit ($1/$2 USD) - 2022/01/16 11:19:32 ET
Table 'Atalante' 6-max Seat #2 is the button
Seat 1: iknewyouhadit ($200 in chips)
Seat 2: CharlieM84 ($200 in chips)
Seat 3: rkinney64 ($239.19 in chips)
Seat 4: MiltonBradley ($267.45 in chips)
Seat 6: win4dwddalways ($317 in chips)
rkinney64: posts small blind $1
MiltonBradley: posts big blind $2
*** HOLE CARDS ***
win4dwddalways: folds
iknewyouhadit: folds
CharlieM84: folds
rkinney64: raises $4 to $6
jack wipe7 joins the table at seat #5
MiltonBradley: folds
Uncalled bet ($4) returned to rkinney64
rkinney64 collected $4 from pot
rkinney64: doesn't show hand
*** SUMMARY ***
Total pot $4 | Rake $0
Seat 1: iknewyouhadit folded before Flop (didn't bet)
Seat 2: CharlieM84 (button) folded before Flop (didn't bet)
Seat 3: rkinney64 (small blind) collected ($4)
Seat 4: MiltonBradley (big blind) folded before Flop
Seat 6: win4dwddalways folded before Flop (didn't bet)


PokerStars Hand #232991729960:  Hold'em No Limit ($1/$2 USD) - 2022/01/16 11:19:55 ET
Table 'Atalante' 6-max Seat #3 is the button
Seat 1: iknewyouhadit ($200 in chips)
Seat 2: CharlieM84 ($200 in chips)
Seat 3: rkinney64 ($241.19 in chips)
Seat 4: MiltonBradley ($265.45 in chips)
Seat 5: jack wipe7 ($80 in chips)
Seat 6: win4dwddalways ($317 in chips)
MiltonBradley: posts small blind $1
jack wipe7: posts big blind $2
*** HOLE CARDS ***
win4dwddalways: folds
iknewyouhadit: folds
CharlieM84: folds
rkinney64: raises $4 to $6
MiltonBradley: raises $14 to $20
jack wipe7: folds
rkinney64: calls $14
*** FLOP *** [3h 3c Kd]
MiltonBradley: checks
rkinney64: checks
*** TURN *** [3h 3c Kd] [3d]
MiltonBradley: bets $9.58
rkinney64: calls $9.58
*** RIVER *** [3h 3c Kd 3d] [4h]
MiltonBradley: checks
rkinney64: bets $22
MiltonBradley: calls $22
*** SHOW DOWN ***
rkinney64: shows [8c 8d] (a full house, Threes full of Eights)
MiltonBradley: shows [Th Td] (a full house, Threes full of Tens)
MiltonBradley collected $102.16 from pot
*** SUMMARY ***
Total pot $105.16 | Rake $3
Board [3h 3c Kd 3d 4h]
Seat 1: iknewyouhadit folded before Flop (didn't bet)
Seat 2: CharlieM84 folded before Flop (didn't bet)
Seat 3: rkinney64 (button) showed [8c 8d] and lost with a full house, Threes full of Eights
Seat 4: MiltonBradley (small blind) showed [Th Td] and won ($102.16) with a full house, Threes full of Tens
Seat 5: jack wipe7 (big blind) folded before Flop
Seat 6: win4dwddalways folded before Flop (didn't bet)


PokerStars Hand #232991992907:  Hold'em No Limit ($1/$2 USD) - 2022/01/16 11:21:14 ET
Table 'Atalante' 6-max Seat #4 is the button
Seat 1: iknewyouhadit ($200 in chips)
Seat 2: CharlieM84 ($200 in chips)
Seat 3: rkinney64 ($189.61 in chips)
Seat 4: MiltonBradley ($316.03 in chips)
Seat 5: jack wipe7 ($78 in chips)
Seat 6: win4dwddalways ($317 in chips)
jack wipe7: posts small blind $1
win4dwddalways: posts big blind $2
*** HOLE CARDS ***
iknewyouhadit: raises $2.60 to $4.60
CharlieM84: folds
rkinney64: folds
MiltonBradley: folds
jack wipe7: folds
win4dwddalways: calls $2.60
*** FLOP *** [2h 3d Td]
win4dwddalways: checks
iknewyouhadit: bets $4.20
win4dwddalways: calls $4.20
*** TURN *** [2h 3d Td] [8h]
win4dwddalways: checks
iknewyouhadit: checks
*** RIVER *** [2h 3d Td 8h] [2c]
win4dwddalways: bets $8.83
iknewyouhadit: calls $8.83
*** SHOW DOWN ***
win4dwddalways: shows [5s 3h] (two pair, Threes and Deuces)
iknewyouhadit: shows [6d 6c] (two pair, Sixes and Deuces)
iknewyouhadit collected $34.45 from pot
*** SUMMARY ***
Total pot $36.26 | Rake $1.81
Board [2h 3d Td 8h 2c]
Seat 1: iknewyouhadit showed [6d 6c] and won ($34.45) with two pair, Sixes and Deuces
Seat 2: CharlieM84 folded before Flop (didn't bet)
Seat 3: rkinney64 folded before Flop (didn't bet)
Seat 4: MiltonBradley (button) folded before Flop (didn't bet)
Seat 5: jack wipe7 (small blind) folded before Flop
Seat 6: win4dwddalways (big blind) showed [5s 3h] and lost with two pair, Threes and Deuces


PokerStars Hand #232991993182:  Hold'em No Limit ($1/$2 USD) - 2022/01/16 11:22:17 ET
Table 'Atalante' 6-max Seat #5 is the button
Seat 1: iknewyouhadit ($216.82 in chips)
Seat 2: CharlieM84 ($200 in chips)
Seat 3: rkinney64 ($189.61 in chips)
Seat 4: MiltonBradley ($316.03 in chips)
Seat 5: jack wipe7 ($77 in chips)
Seat 6: win4dwddalways ($299.37 in chips)
win4dwddalways: posts small blind $1
iknewyouhadit: posts big blind $2
*** HOLE CARDS ***
CharlieM84: raises $3 to $5
rkinney64: folds
MiltonBradley: folds
jack wipe7: folds
win4dwddalways: folds
iknewyouhadit: folds
Uncalled bet ($3) returned to CharlieM84
CharlieM84 collected $5 from pot
CharlieM84: doesn't show hand
*** SUMMARY ***
Total pot $5 | Rake $0
Seat 1: iknewyouhadit (big blind) folded before Flop
Seat 2: CharlieM84 collected ($5)
Seat 3: rkinney64 folded before Flop (didn't bet)
Seat 4: MiltonBradley folded before Flop (didn't bet)
Seat 5: jack wipe7 (button) folded before Flop (didn't bet)
Seat 6: win4dwddalways (small blind) folded before Flop


PokerStars Hand #232991993304:  Hold'em No Limit ($1/$2 USD) - 2022/01/16 11:22:45 ET
Table 'Atalante' 6-max Seat #6 is the button
Seat 1: iknewyouhadit ($214.82 in chips)
Seat 2: CharlieM84 ($203 in chips)
Seat 3: rkinney64 ($189.61 in chips)
Seat 4: MiltonBradley ($316.03 in chips)
Seat 5: jack wipe7 ($77 in chips)
Seat 6: win4dwddalways ($298.37 in chips)
iknewyouhadit: posts small blind $1
CharlieM84: posts big blind $2
*** HOLE CARDS ***
rkinney64: folds
MiltonBradley: folds
jack wipe7: folds
win4dwddalways: folds
iknewyouhadit: folds
Uncalled bet ($1) returned to CharlieM84
CharlieM84 collected $2 from pot
CharlieM84: doesn't show hand
*** SUMMARY ***
Total pot $2 | Rake $0
Seat 1: iknewyouhadit (small blind) folded before Flop
Seat 2: CharlieM84 (big blind) collected ($2)
Seat 3: rkinney64 folded before Flop (didn't bet)
Seat 4: MiltonBradley folded before Flop (didn't bet)
Seat 5: jack wipe7 folded before Flop (didn't bet)
Seat 6: win4dwddalways (button) folded before Flop (didn't bet)


PokerStars Hand #232991993413:  Hold'em No Limit ($1/$2 USD) - 2022/01/16 11:23:05 ET
Table 'Atalante' 6-max Seat #1 is the button
Seat 1: iknewyouhadit ($213.82 in chips)
Seat 2: CharlieM84 ($204 in chips)
Seat 3: rkinney64 ($189.61 in chips)
Seat 4: MiltonBradley ($316.03 in chips)
Seat 5: jack wipe7 ($77 in chips)
Seat 6: win4dwddalways ($298.37 in chips)
CharlieM84: posts small blind $1
rkinney64: posts big blind $2
*** HOLE CARDS ***
MiltonBradley: folds
jack wipe7: folds
win4dwddalways: folds
iknewyouhadit: raises $2.60 to $4.60
CharlieM84: folds
rkinney64: folds
Uncalled bet ($2.60) returned to iknewyouhadit
iknewyouhadit collected $5 from pot
*** SUMMARY ***
Total pot $5 | Rake $0
Seat 1: iknewyouhadit (button) collected ($5)
Seat 2: CharlieM84 (small blind) folded before Flop
Seat 3: rkinney64 (big blind) folded before Flop
Seat 4: MiltonBradley folded before Flop (didn't bet)
Seat 5: jack wipe7 folded before Flop (didn't bet)
Seat 6: win4dwddalways folded before Flop (didn't bet)


PokerStars Hand #232991993473:  Hold'em No Limit ($1/$2 USD) - 2022/01/16 11:23:19 ET
Table 'Atalante' 6-max Seat #2 is the button
Seat 1: iknewyouhadit ($216.82 in chips)
Seat 2: CharlieM84 ($203 in chips)
Seat 3: rkinney64 ($187.61 in chips)
Seat 4: MiltonBradley ($316.03 in chips)
Seat 5: jack wipe7 ($77 in chips)
Seat 6: win4dwddalways ($298.37 in chips)
rkinney64: posts small blind $1
MiltonBradley: posts big blind $2
*** HOLE CARDS ***
jack wipe7: folds
win4dwddalways: raises $4 to $6
iknewyouhadit: folds
CharlieM84: folds
rkinney64: calls $5
MiltonBradley: folds
*** FLOP *** [9d 6s 4s]
rkinney64: checks
win4dwddalways: checks
*** TURN *** [9d 6s 4s] [Ah]
rkinney64: checks
win4dwddalways: bets $6.65
rkinney64: folds
Uncalled bet ($6.65) returned to win4dwddalways
win4dwddalways collected $13.30 from pot
win4dwddalways: doesn't show hand
*** SUMMARY ***
Total pot $14 | Rake $0.70
Board [9d 6s 4s Ah]
Seat 1: iknewyouhadit folded before Flop (didn't bet)
Seat 2: CharlieM84 (button) folded before Flop (didn't bet)
Seat 3: rkinney64 (small blind) folded on the Turn
Seat 4: MiltonBradley (big blind) folded before Flop
Seat 5: jack wipe7 folded before Flop (didn't bet)
Seat 6: win4dwddalways collected ($13.30)


PokerStars Hand #232991993596:  Hold'em No Limit ($1/$2 USD) - 2022/01/16 11:23:46 ET
Table 'Atalante' 6-max Seat #3 is the button
Seat 1: iknewyouhadit ($216.82 in chips)
Seat 2: CharlieM84 ($203 in chips)
Seat 3: rkinney64 ($181.61 in chips)
Seat 4: MiltonBradley ($314.03 in chips)
Seat 5: jack wipe7 ($77 in chips)
Seat 6: win4dwddalways ($305.67 in chips)
MiltonBradley: posts small blind $1
jack wipe7: posts big blind $2
*** HOLE CARDS ***
win4dwddalways: folds
iknewyouhadit: raises $2.60 to $4.60
CharlieM84: folds
rkinney64: folds
MiltonBradley: folds
jack wipe7: calls $2.60
*** FLOP *** [6d Jc 5h]
jack wipe7: checks
iknewyouhadit: checks
*** TURN *** [6d Jc 5h] [Th]
jack wipe7: bets $6
iknewyouhadit: calls $6
*** RIVER *** [6d Jc 5h Th] [Tc]
jack wipe7: bets $12
iknewyouhadit: raises $56 to $68
jack wipe7: folds
Uncalled bet ($56) returned to iknewyouhadit
iknewyouhadit collected $43.89 from pot
*** SUMMARY ***
Total pot $46.20 | Rake $2.31
Board [6d Jc 5h Th Tc]
Seat 1: iknewyouhadit collected ($43.89)
Seat 2: CharlieM84 folded before Flop (didn't bet)
Seat 3: rkinney64 (button) folded before Flop (didn't bet)
Seat 4: MiltonBradley (small blind) folded before Flop
Seat 5: jack wipe7 (big blind) folded on the River
Seat 6: win4dwddalways folded before Flop (didn't bet)


PokerStars Hand #232991993920:  Hold'em No Limit ($1/$2 USD) - 2022/01/16 11:24:58 ET
Table 'Atalante' 6-max Seat #4 is the button
Seat 1: iknewyouhadit ($238.11 in chips)
Seat 2: CharlieM84 ($203 in chips)
Seat 3: rkinney64 ($181.61 in chips)
Seat 4: MiltonBradley ($313.03 in chips)
Seat 5: jack wipe7 ($54.40 in chips)
Seat 6: win4dwddalways ($305.67 in chips)
jack wipe7: posts small blind $1
win4dwddalways: posts big blind $2
*** HOLE CARDS ***
iknewyouhadit: folds
CharlieM84: folds
rkinney64: folds
MiltonBradley: raises $2.42 to $4.42
jack wipe7: folds
win4dwddalways: folds
Uncalled bet ($2.42) returned to MiltonBradley
MiltonBradley collected $5 from pot
MiltonBradley: doesn't show hand
*** SUMMARY ***
Total pot $5 | Rake $0
Seat 1: iknewyouhadit folded before Flop (didn't bet)
Seat 2: CharlieM84 folded before Flop (didn't bet)
Seat 3: rkinney64 folded before Flop (didn't bet)
Seat 4: MiltonBradley (button) collected ($5)
Seat 5: jack wipe7 (small blind) folded before Flop
Seat 6: win4dwddalways (big blind) folded before Flop


PokerStars Hand #232991994040:  Hold'em No Limit ($1/$2 USD) - 2022/01/16 11:25:22 ET
Table 'Atalante' 6-max Seat #5 is the button
Seat 1: iknewyouhadit ($238.11 in chips)
Seat 2: CharlieM84 ($203 in chips)
Seat 3: rkinney64 ($181.61 in chips)
Seat 4: MiltonBradley ($316.03 in chips)
Seat 5: jack wipe7 ($53.40 in chips)
Seat 6: win4dwddalways ($303.67 in chips)
win4dwddalways: posts small blind $1
iknewyouhadit: posts big blind $2
*** HOLE CARDS ***
CharlieM84: folds
rkinney64: raises $4 to $6
MiltonBradley: folds
jack wipe7: folds
win4dwddalways: folds
iknewyouhadit: folds
Uncalled bet ($4) returned to rkinney64
rkinney64 collected $5 from pot
rkinney64: doesn't show hand
*** SUMMARY ***
Total pot $5 | Rake $0
Seat 1: iknewyouhadit (big blind) folded before Flop
Seat 2: CharlieM84 folded before Flop (didn't bet)
Seat 3: rkinney64 collected ($5)
Seat 4: MiltonBradley folded before Flop (didn't bet)
Seat 5: jack wipe7 (button) folded before Flop (didn't bet)
Seat 6: win4dwddalways (small blind) folded before Flop


PokerStars Hand #232991994125:  Hold'em No Limit ($1/$2 USD) - 2022/01/16 11:25:41 ET
Table 'Atalante' 6-max Seat #6 is the button
Seat 1: iknewyouhadit ($236.11 in chips)
Seat 2: CharlieM84 ($203 in chips)
Seat 3: rkinney64 ($184.61 in chips)
Seat 4: MiltonBradley ($316.03 in chips)
Seat 5: jack wipe7 ($53.40 in chips)
Seat 6: win4dwddalways ($302.67 in chips)
iknewyouhadit: posts small blind $1
CharlieM84: posts big blind $2
*** HOLE CARDS ***
rkinney64: folds
MiltonBradley: folds
jack wipe7: folds
win4dwddalways: raises $4 to $6
iknewyouhadit: folds
CharlieM84: calls $4
*** FLOP *** [4c 2h 6h]
CharlieM84: checks
win4dwddalways: bets $8.17
CharlieM84: folds
Uncalled bet ($8.17) returned to win4dwddalways
win4dwddalways collected $12.35 from pot
win4dwddalways: doesn't show hand
*** SUMMARY ***
Total pot $13 | Rake $0.65
Board [4c 2h 6h]
Seat 1: iknewyouhadit (small blind) folded before Flop
Seat 2: CharlieM84 (big blind) folded on the Flop
Seat 3: rkinney64 folded before Flop (didn't bet)
Seat 4: MiltonBradley folded before Flop (didn't bet)
Seat 5: jack wipe7 folded before Flop (didn't bet)
Seat 6: win4dwddalways (button) collected ($12.35)


PokerStars Hand #232991994310:  Hold'em No Limit ($1/$2 USD) - 2022/01/16 11:26:17 ET
Table 'Atalante' 6-max Seat #1 is the button
Seat 1: iknewyouhadit ($235.11 in chips)
Seat 2: CharlieM84 ($200 in chips)
Seat 3: rkinney64 ($184.61 in chips)
Seat 4: MiltonBradley ($316.03 in chips)
Seat 5: jack wipe7 ($53.40 in chips)
Seat 6: win4dwddalways ($309.02 in chips)
CharlieM84: posts small blind $1
rkinney64: posts big blind $2
*** HOLE CARDS ***
MiltonBradley: folds
jack wipe7: calls $2
win4dwddalways: folds
iknewyouhadit: folds
CharlieM84: folds
rkinney64: checks
*** FLOP *** [2h 7c As]
rkinney64: checks
jack wipe7: bets $4
rkinney64: folds
Uncalled bet ($4) returned to jack wipe7
jack wipe7 collected $4.75 from pot
jack wipe7: doesn't show hand
*** SUMMARY ***
Total pot $5 | Rake $0.25
Board [2h 7c As]
Seat 1: iknewyouhadit (button) folded before Flop (didn't bet)
Seat 2: CharlieM84 (small blind) folded before Flop
Seat 3: rkinney64 (big blind) folded on the Flop
Seat 4: MiltonBradley folded before Flop (didn't bet)
Seat 5: jack wipe7 collected ($4.75)
Seat 6: win4dwddalways folded before Flop (didn't bet)


PokerStars Hand #232991994426:  Hold'em No Limit ($1/$2 USD) - 2022/01/16 11:26:40 ET
Table 'Atalante' 6-max Seat #2 is the button
Seat 1: iknewyouhadit ($235.11 in chips)
Seat 2: CharlieM84 ($200 in chips)
Seat 3: rkinney64 ($182.61 in chips)
Seat 4: MiltonBradley ($316.03 in chips)
Seat 5: jack wipe7 ($56.15 in chips)
Seat 6: win4dwddalways ($309.02 in chips)
rkinney64: posts small blind $1
MiltonBradley: posts big blind $2
*** HOLE CARDS ***
jack wipe7: folds
win4dwddalways: folds
iknewyouhadit: raises $2.60 to $4.60
CharlieM84: folds
rkinney64: folds
MiltonBradley: calls $2.60
*** FLOP *** [Jh 3d Jd]
MiltonBradley: checks
iknewyouhadit: checks
*** TURN *** [Jh 3d Jd] [Ks]
MiltonBradley: checks
iknewyouhadit: checks
*** RIVER *** [Jh 3d Jd Ks] [Js]
MiltonBradley: bets $5.04
iknewyouhadit: calls $5.04
*** SHOW DOWN ***
MiltonBradley: shows [6c 9c] (three of a kind, Jacks)
iknewyouhadit: shows [4h 4d] (a full house, Jacks full of Fours)
iknewyouhadit collected $19.27 from pot
*** SUMMARY ***
Total pot $20.28 | Rake $1.01
Board [Jh 3d Jd Ks Js]
Seat 1: iknewyouhadit showed [4h 4d] and won ($19.27) with a full house, Jacks full of Fours
Seat 2: CharlieM84 (button) folded before Flop (didn't bet)
Seat 3: rkinney64 (small blind) folded before Flop
Seat 4: MiltonBradley (big blind) showed [6c 9c] and lost with three of a kind, Jacks
Seat 5: jack wipe7 folded before Flop (didn't bet)
Seat 6: win4dwddalways folded before Flop (didn't bet)


PokerStars Hand #232991994726:  Hold'em No Limit ($1/$2 USD) - 2022/01/16 11:27:43 ET
Table 'Atalante' 6-max Seat #3 is the button
Seat 1: iknewyouhadit ($244.74 in chips)
Seat 2: CharlieM84 ($200 in chips)
Seat 3: rkinney64 ($181.61 in chips)
Seat 4: MiltonBradley ($306.39 in chips)
Seat 5: jack wipe7 ($56.15 in chips)
Seat 6: win4dwddalways ($309.02 in chips)
MiltonBradley: posts small blind $1
jack wipe7: posts big blind $2
*** HOLE CARDS ***
win4dwddalways: folds
iknewyouhadit: folds
CharlieM84: folds
rkinney64: folds
MiltonBradley: folds
Uncalled bet ($1) returned to jack wipe7
jack wipe7 collected $2 from pot
jack wipe7: doesn't show hand
*** SUMMARY ***
Total pot $2 | Rake $0
Seat 1: iknewyouhadit folded before Flop (didn't bet)
Seat 2: CharlieM84 folded before Flop (didn't bet)
Seat 3: rkinney64 (button) folded before Flop (didn't bet)
Seat 4: MiltonBradley (small blind) folded before Flop
Seat 5: jack wipe7 (big blind) collected ($2)
Seat 6: win4dwddalways folded before Flop (didn't bet)


PokerStars Hand #232991994787:  Hold'em No Limit ($1/$2 USD) - 2022/01/16 11:27:56 ET
Table 'Atalante' 6-max Seat #4 is the button
Seat 1: iknewyouhadit ($244.74 in chips)
Seat 2: CharlieM84 ($200 in chips)
Seat 3: rkinney64 ($181.61 in chips)
Seat 4: MiltonBradley ($305.39 in chips)
Seat 5: jack wipe7 ($57.15 in chips)
Seat 6: win4dwddalways ($309.02 in chips)
jack wipe7: posts small blind $1
win4dwddalways: posts big blind $2
*** HOLE CARDS ***
iknewyouhadit: folds
CharlieM84: folds
rkinney64: folds
MiltonBradley: folds
jack wipe7: calls $1
win4dwddalways: checks
*** FLOP *** [Qs Jd 8h]
jack wipe7: checks
win4dwddalways: bets $2
jack wipe7: calls $2
*** TURN *** [Qs Jd 8h] [2s]
jack wipe7: checks
win4dwddalways: bets $2
jack wipe7: calls $2
*** RIVER *** [Qs Jd 8h 2s] [Ks]
jack wipe7: checks
win4dwddalways: checks
*** SHOW DOWN ***
jack wipe7: shows [8s 6h] (a pair of Eights)
win4dwddalways: shows [4c Jh] (a pair of Jacks)
win4dwddalways collected $11.40 from pot
*** SUMMARY ***
Total pot $12 | Rake $0.60
Board [Qs Jd 8h 2s Ks]
Seat 1: iknewyouhadit folded before Flop (didn't bet)
Seat 2: CharlieM84 folded before Flop (didn't bet)
Seat 3: rkinney64 folded before Flop (didn't bet)
Seat 4: MiltonBradley (button) folded before Flop (didn't bet)
Seat 5: jack wipe7 (small blind) showed [8s 6h] and lost with a pair of Eights
Seat 6: win4dwddalways (big blind) showed [4c Jh] and won ($11.40) with a pair of Jacks


PokerStars Hand #232991995044:  Hold'em No Limit ($1/$2 USD) - 2022/01/16 11:28:43 ET
Table 'Atalante' 6-max Seat #5 is the button
Seat 1: iknewyouhadit ($244.74 in chips)
Seat 2: CharlieM84 ($200 in chips)
Seat 3: rkinney64 ($181.61 in chips)
Seat 4: MiltonBradley ($305.39 in chips)
Seat 5: jack wipe7 ($51.15 in chips)
Seat 6: win4dwddalways ($314.42 in chips)
win4dwddalways: posts small blind $1
iknewyouhadit: posts big blind $2
*** HOLE CARDS ***
CharlieM84: raises $3 to $5
rkinney64: folds
MiltonBradley: folds
jack wipe7: folds
win4dwddalways: calls $4
iknewyouhadit: folds
*** FLOP *** [2h Qh 6h]
win4dwddalways: checks
CharlieM84: checks
*** TURN *** [2h Qh 6h] [Ad]
win4dwddalways: checks
CharlieM84: checks
*** RIVER *** [2h Qh 6h Ad] [4c]
win4dwddalways: checks
CharlieM84: checks
*** SHOW DOWN ***
win4dwddalways: shows [8c Tc] (high card Ace)
CharlieM84: shows [Ts 9s] (high card Ace - Queen+Ten+Nine kicker)
CharlieM84 collected $11.40 from pot
*** SUMMARY ***
Total pot $12 | Rake $0.60
Board [2h Qh 6h Ad 4c]
Seat 1: iknewyouhadit (big blind) folded before Flop
Seat 2: CharlieM84 showed [Ts 9s] and won ($11.40) with high card Ace
Seat 3: rkinney64 folded before Flop (didn't bet)
Seat 4: MiltonBradley folded before Flop (didn't bet)
Seat 5: jack wipe7 (button) folded before Flop (didn't bet)
Seat 6: win4dwddalways (small blind) showed [8c Tc] and lost with high card Ace


PokerStars Hand #232991995312:  Hold'em No Limit ($1/$2 USD) - 2022/01/16 11:29:31 ET
Table 'Atalante' 6-max Seat #6 is the button
Seat 1: iknewyouhadit ($242.74 in chips)
Seat 2: CharlieM84 ($206.40 in chips)
Seat 3: rkinney64 ($181.61 in chips)
Seat 4: MiltonBradley ($305.39 in chips)
Seat 5: jack wipe7 ($51.15 in chips)
Seat 6: win4dwddalways ($309.42 in chips)
iknewyouhadit: posts small blind $1
CharlieM84: posts big blind $2
*** HOLE CARDS ***
rkinney64: folds
MiltonBradley: folds
jack wipe7: folds
win4dwddalways: raises $4 to $6
iknewyouhadit: folds
CharlieM84: folds
Uncalled bet ($4) returned to win4dwddalways
win4dwddalways collected $5 from pot
win4dwddalways: doesn't show hand
*** SUMMARY ***
Total pot $5 | Rake $0
Seat 1: iknewyouhadit (small blind) folded before Flop
Seat 2: CharlieM84 (big blind) folded before Flop
Seat 3: rkinney64 folded before Flop (didn't bet)
Seat 4: MiltonBradley folded before Flop (didn't bet)
Seat 5: jack wipe7 folded before Flop (didn't bet)
Seat 6: win4dwddalways (button) collected ($5)


PokerStars Hand #232991995401:  Hold'em No Limit ($1/$2 USD) - 2022/01/16 11:29:47 ET
Table 'Atalante' 6-max Seat #1 is the button
Seat 1: iknewyouhadit ($241.74 in chips)
Seat 2: CharlieM84 ($204.40 in chips)
Seat 3: rkinney64 ($181.61 in chips)
Seat 4: MiltonBradley ($305.39 in chips)
Seat 5: jack wipe7 ($51.15 in chips)
Seat 6: win4dwddalways ($312.42 in chips)
CharlieM84: posts small blind $1
rkinney64: posts big blind $2
*** HOLE CARDS ***
MiltonBradley: raises $2.18 to $4.18
jack wipe7: folds
win4dwddalways: folds
iknewyouhadit: folds
CharlieM84: folds
rkinney64: folds
Uncalled bet ($2.18) returned to MiltonBradley
MiltonBradley collected $5 from pot
MiltonBradley: doesn't show hand
*** SUMMARY ***
Total pot $5 | Rake $0
Seat 1: iknewyouhadit (button) folded before Flop (didn't bet)
Seat 2: CharlieM84 (small blind) folded before Flop
Seat 3: rkinney64 (big blind) folded before Flop
Seat 4: MiltonBradley collected ($5)
Seat 5: jack wipe7 folded before Flop (didn't bet)
Seat 6: win4dwddalways folded before Flop (didn't bet)


PokerStars Hand #232991995470:  Hold'em No Limit ($1/$2 USD) - 2022/01/16 11:30:04 ET
Table 'Atalante' 6-max Seat #2 is the button
Seat 1: iknewyouhadit ($241.74 in chips)
Seat 2: CharlieM84 ($203.40 in chips)
Seat 3: rkinney64 ($179.61 in chips)
Seat 5: jack wipe7 ($51.15 in chips)
Seat 6: win4dwddalways ($312.42 in chips)
rkinney64: posts small blind $1
MiltonBradley: is sitting out
jack wipe7: posts big blind $2
*** HOLE CARDS ***
win4dwddalways: raises $4 to $6
iknewyouhadit: folds
CharlieM84: folds
rkinney64: folds
MiltonBradley leaves the table
jack wipe7: calls $4
*** FLOP *** [Ac 5h Qd]
jack wipe7: checks
win4dwddalways: bets $2
dnagel222 joins the table at seat #4
jack wipe7: calls $2
*** TURN *** [Ac 5h Qd] [2c]
jack wipe7: checks
win4dwddalways: checks
*** RIVER *** [Ac 5h Qd 2c] [8d]
jack wipe7: bets $6
win4dwddalways: calls $6
*** SHOW DOWN ***
jack wipe7: shows [4h Qh] (a pair of Queens)
win4dwddalways: mucks hand
jack wipe7 collected $27.55 from pot
*** SUMMARY ***
Total pot $29 | Rake $1.45
Board [Ac 5h Qd 2c 8d]
Seat 1: iknewyouhadit folded before Flop (didn't bet)
Seat 2: CharlieM84 (button) folded before Flop (didn't bet)
Seat 3: rkinney64 (small blind) folded before Flop
Seat 5: jack wipe7 (big blind) showed [4h Qh] and won ($27.55) with a pair of Queens
Seat 6: win4dwddalways mucked


PokerStars Hand #232991995713:  Hold'em No Limit ($1/$2 USD) - 2022/01/16 11:30:47 ET
Table 'Atalante' 6-max Seat #3 is the button
Seat 1: iknewyouhadit ($241.74 in chips)
Seat 2: CharlieM84 ($203.40 in chips)
Seat 3: rkinney64 ($178.61 in chips)
Seat 5: jack wipe7 ($64.70 in chips)
Seat 6: win4dwddalways ($298.42 in chips)
jack wipe7: posts small blind $1
win4dwddalways: posts big blind $2
*** HOLE CARDS ***
iknewyouhadit: folds
CharlieM84: raises $3 to $5
rkinney64: folds
jack wipe7: folds
win4dwddalways: folds
Uncalled bet ($3) returned to CharlieM84
CharlieM84 collected $5 from pot
CharlieM84: doesn't show hand
*** SUMMARY ***
Total pot $5 | Rake $0
Seat 1: iknewyouhadit folded before Flop (didn't bet)
Seat 2: CharlieM84 collected ($5)
Seat 3: rkinney64 (button) folded before Flop (didn't bet)
Seat 5: jack wipe7 (small blind) folded before Flop
Seat 6: win4dwddalways (big blind) folded before Flop


PokerStars Hand #232991995805:  Hold'em No Limit ($1/$2 USD) - 2022/01/16 11:31:05 ET
Table 'Atalante' 6-max Seat #5 is the button
Seat 1: iknewyouhadit ($241.74 in chips)
Seat 2: CharlieM84 ($206.40 in chips)
Seat 3: rkinney64 ($178.61 in chips)
Seat 5: jack wipe7 ($63.70 in chips)
Seat 6: win4dwddalways ($296.42 in chips)
win4dwddalways: posts small blind $1
iknewyouhadit: posts big blind $2
dnagel222: sits out
*** HOLE CARDS ***
CharlieM84: raises $3 to $5
rkinney64: folds
jack wipe7: folds
win4dwddalways: folds
iknewyouhadit: calls $3
*** FLOP *** [6d Qd Ts]
iknewyouhadit: checks
CharlieM84: bets $7.84
iknewyouhadit: raises $19.86 to $27.70
CharlieM84: raises $49.39 to $77.09
iknewyouhadit: raises $159.65 to $236.74 and is all-in
CharlieM84: calls $124.31 and is all-in
Uncalled bet ($35.34) returned to iknewyouhadit
*** TURN *** [6d Qd Ts] [As]
*** RIVER *** [6d Qd Ts As] [3d]
*** SHOW DOWN ***
iknewyouhadit: shows [6s Qs] (two pair, Queens and Sixes)
CharlieM84: shows [9d Jd] (a flush, Queen high)
CharlieM84 collected $410.80 from pot
*** SUMMARY ***
Total pot $413.80 | Rake $3
Board [6d Qd Ts As 3d]
Seat 1: iknewyouhadit (big blind) showed [6s Qs] and lost with two pair, Queens and Sixes
Seat 2: CharlieM84 showed [9d Jd] and won ($410.80) with a flush, Queen high
Seat 3: rkinney64 folded before Flop (didn't bet)
Seat 5: jack wipe7 (button) folded before Flop (didn't bet)
Seat 6: win4dwddalways (small blind) folded before Flop


PokerStars Hand #232991996193:  Hold'em No Limit ($1/$2 USD) - 2022/01/16 11:32:17 ET
Table 'Atalante' 6-max Seat #6 is the button
Seat 1: iknewyouhadit ($200 in chips)
Seat 2: CharlieM84 ($410.80 in chips)
Seat 3: rkinney64 ($178.61 in chips)
Seat 5: jack wipe7 ($63.70 in chips)
Seat 6: win4dwddalways ($295.42 in chips)
iknewyouhadit: posts small blind $1
CharlieM84: posts big blind $2
dnagel222: sits out
*** HOLE CARDS ***
rkinney64: raises $4 to $6
jack wipe7: folds
win4dwddalways: folds
iknewyouhadit: calls $5
CharlieM84: folds
*** FLOP *** [Qs 6c 5s]
iknewyouhadit: checks
rkinney64: checks
*** TURN *** [Qs 6c 5s] [Qd]
iknewyouhadit: checks
rkinney64: checks
*** RIVER *** [Qs 6c 5s Qd] [3c]
iknewyouhadit: checks
rkinney64: bets $10
iknewyouhadit: calls $10
*** SHOW DOWN ***
rkinney64: shows [Ac Kh] (a pair of Queens)
iknewyouhadit: shows [2d 2h] (two pair, Queens and Deuces)
iknewyouhadit collected $32.30 from pot
*** SUMMARY ***
Total pot $34 | Rake $1.70
Board [Qs 6c 5s Qd 3c]
Seat 1: iknewyouhadit (small blind) showed [2d 2h] and won ($32.30) with two pair, Queens and Deuces
Seat 2: CharlieM84 (big blind) folded before Flop
Seat 3: rkinney64 showed [Ac Kh] and lost with a pair of Queens
Seat 5: jack wipe7 folded before Flop (didn't bet)
Seat 6: win4dwddalways (button) folded before Flop (didn't bet)


PokerStars Hand #232991996539:  Hold'em No Limit ($1/$2 USD) - 2022/01/16 11:33:16 ET
Table 'Atalante' 6-max Seat #1 is the button
Seat 1: iknewyouhadit ($216.30 in chips)
Seat 2: CharlieM84 ($408.80 in chips)
Seat 3: rkinney64 ($162.61 in chips)
Seat 5: jack wipe7 ($63.70 in chips)
Seat 6: win4dwddalways ($295.42 in chips)
CharlieM84: posts small blind $1
rkinney64: posts big blind $2
dnagel222: sits out
*** HOLE CARDS ***
jack wipe7: folds
win4dwddalways: raises $4 to $6
iknewyouhadit: folds
CharlieM84: folds
rkinney64: folds
Uncalled bet ($4) returned to win4dwddalways
win4dwddalways collected $5 from pot
win4dwddalways: doesn't show hand
*** SUMMARY ***
Total pot $5 | Rake $0
Seat 1: iknewyouhadit (button) folded before Flop (didn't bet)
Seat 2: CharlieM84 (small blind) folded before Flop
Seat 3: rkinney64 (big blind) folded before Flop
Seat 5: jack wipe7 folded before Flop (didn't bet)
Seat 6: win4dwddalways collected ($5)


PokerStars Hand #232991996620:  Hold'em No Limit ($1/$2 USD) - 2022/01/16 11:33:30 ET
Table 'Atalante' 6-max Seat #2 is the button
Seat 1: iknewyouhadit ($216.30 in chips)
Seat 2: CharlieM84 ($407.80 in chips)
Seat 3: rkinney64 ($160.61 in chips)
Seat 4: dnagel222 ($80 in chips)
Seat 5: jack wipe7 ($63.70 in chips)
Seat 6: win4dwddalways ($298.42 in chips)
rkinney64: posts small blind $1
dnagel222: posts big blind $2
*** HOLE CARDS ***
jack wipe7: folds
win4dwddalways: folds
iknewyouhadit: folds
CharlieM84: raises $3 to $5
rkinney64: folds
dnagel222: folds
Uncalled bet ($3) returned to CharlieM84
CharlieM84 collected $5 from pot
CharlieM84: doesn't show hand
*** SUMMARY ***
Total pot $5 | Rake $0
Seat 1: iknewyouhadit folded before Flop (didn't bet)
Seat 2: CharlieM84 (button) collected ($5)
Seat 3: rkinney64 (small blind) folded before Flop
Seat 4: dnagel222 (big blind) folded before Flop
Seat 5: jack wipe7 folded before Flop (didn't bet)
Seat 6: win4dwddalways folded before Flop (didn't bet)


PokerStars Hand #232991996770:  Hold'em No Limit ($1/$2 USD) - 2022/01/16 11:33:58 ET
Table 'Atalante' 6-max Seat #3 is the button
Seat 1: iknewyouhadit ($216.30 in chips)
Seat 2: CharlieM84 ($410.80 in chips)
Seat 3: rkinney64 ($159.61 in chips)
Seat 4: dnagel222 ($78 in chips)
Seat 5: jack wipe7 ($63.70 in chips)
Seat 6: win4dwddalways ($298.42 in chips)
dnagel222: posts small blind $1
jack wipe7: posts big blind $2
*** HOLE CARDS ***
win4dwddalways: raises $4 to $6
iknewyouhadit: folds
CharlieM84: folds
rkinney64: folds
dnagel222: calls $5
jack wipe7: folds
*** FLOP *** [5c 9d 3s]
dnagel222: bets $13.30
win4dwddalways: folds
Uncalled bet ($13.30) returned to dnagel222
dnagel222 collected $13.30 from pot
*** SUMMARY ***
Total pot $14 | Rake $0.70
Board [5c 9d 3s]
Seat 1: iknewyouhadit folded before Flop (didn't bet)
Seat 2: CharlieM84 folded before Flop (didn't bet)
Seat 3: rkinney64 (button) folded before Flop (didn't bet)
Seat 4: dnagel222 (small blind) collected ($13.30)
Seat 5: jack wipe7 (big blind) folded before Flop
Seat 6: win4dwddalways folded on the Flop


PokerStars Hand #232991996938:  Hold'em No Limit ($1/$2 USD) - 2022/01/16 11:34:32 ET
Table 'Atalante' 6-max Seat #4 is the button
Seat 1: iknewyouhadit ($216.30 in chips)
Seat 2: CharlieM84 ($410.80 in chips)
Seat 3: rkinney64 ($159.61 in chips)
Seat 4: dnagel222 ($85.30 in chips)
Seat 5: jack wipe7 ($61.70 in chips)
jack wipe7: posts small blind $1
win4dwddalways: is sitting out
iknewyouhadit: posts big blind $2
*** HOLE CARDS ***
CharlieM84: folds
win4dwddalways leaves the table
rkinney64: folds
dnagel222: raises $5 to $7
jack wipe7: folds
iknewyouhadit: folds
Uncalled bet ($5) returned to dnagel222
dnagel222 collected $5 from pot
*** SUMMARY ***
Total pot $5 | Rake $0
Seat 1: iknewyouhadit (big blind) folded before Flop
Seat 2: CharlieM84 folded before Flop (didn't bet)
Seat 3: rkinney64 folded before Flop (didn't bet)
Seat 4: dnagel222 (button) collected ($5)
Seat 5: jack wipe7 (small blind) folded before Flop


PokerStars Hand #232991997027:  Hold'em No Limit ($1/$2 USD) - 2022/01/16 11:34:50 ET
Table 'Atalante' 6-max Seat #5 is the button
Seat 1: iknewyouhadit ($214.30 in chips)
Seat 2: CharlieM84 ($410.80 in chips)
Seat 3: rkinney64 ($159.61 in chips)
Seat 4: dnagel222 ($88.30 in chips)
Seat 5: jack wipe7 ($60.70 in chips)
iknewyouhadit: posts small blind $1
CharlieM84: posts big blind $2
*** HOLE CARDS ***
rkinney64: raises $4 to $6
dnagel222: folds
jack wipe7: folds
iknewyouhadit: folds
ColonelPhorbin joins the table at seat #6
CharlieM84: calls $4
*** FLOP *** [Kh 6c Qh]
CharlieM84: checks
rkinney64: bets $8
CharlieM84: folds
Uncalled bet ($8) returned to rkinney64
rkinney64 collected $12.35 from pot
rkinney64: doesn't show hand
*** SUMMARY ***
Total pot $13 | Rake $0.65
Board [Kh 6c Qh]
Seat 1: iknewyouhadit (small blind) folded before Flop
Seat 2: CharlieM84 (big blind) folded on the Flop
Seat 3: rkinney64 collected ($12.35)
Seat 4: dnagel222 folded before Flop (didn't bet)
Seat 5: jack wipe7 (button) folded before Flop (didn't bet)


PokerStars Hand #232991997167:  Hold'em No Limit ($1/$2 USD) - 2022/01/16 11:35:17 ET
Table 'Atalante' 6-max Seat #1 is the button
Seat 1: iknewyouhadit ($213.30 in chips)
Seat 2: CharlieM84 ($404.80 in chips)
Seat 3: rkinney64 ($165.96 in chips)
Seat 4: dnagel222 ($88.30 in chips)
Seat 5: jack wipe7 ($60.70 in chips)
Seat 6: ColonelPhorbin ($200 in chips)
CharlieM84: posts small blind $1
rkinney64: posts big blind $2
ColonelPhorbin: posts big blind $2
*** HOLE CARDS ***
dnagel222: folds
jack wipe7: raises $4 to $6
ColonelPhorbin: calls $4
iknewyouhadit: folds
CharlieM84: folds
rkinney64: folds
*** FLOP *** [6s 3c 9d]
jack wipe7: bets $6
ColonelPhorbin: folds
Uncalled bet ($6) returned to jack wipe7
jack wipe7 collected $14.25 from pot
jack wipe7: doesn't show hand
*** SUMMARY ***
Total pot $15 | Rake $0.75
Board [6s 3c 9d]
Seat 1: iknewyouhadit (button) folded before Flop (didn't bet)
Seat 2: CharlieM84 (small blind) folded before Flop
Seat 3: rkinney64 (big blind) folded before Flop
Seat 4: dnagel222 folded before Flop (didn't bet)
Seat 5: jack wipe7 collected ($14.25)
Seat 6: ColonelPhorbin folded on the Flop


PokerStars Hand #232991997337:  Hold'em No Limit ($1/$2 USD) - 2022/01/16 11:35:51 ET
Table 'Atalante' 6-max Seat #2 is the button
Seat 1: iknewyouhadit ($213.30 in chips)
Seat 2: CharlieM84 ($403.80 in chips)
Seat 3: rkinney64 ($163.96 in chips)
Seat 4: dnagel222 ($88.30 in chips)
Seat 5: jack wipe7 ($68.95 in chips)
Seat 6: ColonelPhorbin ($194 in chips)
rkinney64: posts small blind $1
dnagel222: posts big blind $2
*** HOLE CARDS ***
jack wipe7: calls $2
ColonelPhorbin: folds
iknewyouhadit: folds
CharlieM84: folds
rkinney64: calls $1
dnagel222: checks
*** FLOP *** [4s 4h Qs]
rkinney64: checks
dnagel222: checks
jack wipe7: checks
*** TURN *** [4s 4h Qs] [Jh]
rkinney64: bets $4
dnagel222: folds
jack wipe7: calls $4
*** RIVER *** [4s 4h Qs Jh] [Tc]
rkinney64: bets $4
jack wipe7: raises $8 to $12
rkinney64: calls $8
*** SHOW DOWN ***
jack wipe7: shows [Kh 9h] (a straight, Nine to King)
rkinney64: mucks hand
jack wipe7 collected $36.10 from pot
*** SUMMARY ***
Total pot $38 | Rake $1.90
Board [4s 4h Qs Jh Tc]
Seat 1: iknewyouhadit folded before Flop (didn't bet)
Seat 2: CharlieM84 (button) folded before Flop (didn't bet)
Seat 3: rkinney64 (small blind) mucked
Seat 4: dnagel222 (big blind) folded on the Turn
Seat 5: jack wipe7 showed [Kh 9h] and won ($36.10) with a straight, Nine to King
Seat 6: ColonelPhorbin folded before Flop (didn't bet)


PokerStars Hand #232991997571:  Hold'em No Limit ($1/$2 USD) - 2022/01/16 11:36:39 ET
Table 'Atalante' 6-max Seat #3 is the button
Seat 1: iknewyouhadit ($213.30 in chips)
Seat 2: CharlieM84 ($403.80 in chips)
Seat 3: rkinney64 ($145.96 in chips)
Seat 4: dnagel222 ($86.30 in chips)
Seat 5: jack wipe7 ($87.05 in chips)
Seat 6: ColonelPhorbin ($194 in chips)
dnagel222: posts small blind $1
jack wipe7: posts big blind $2
*** HOLE CARDS ***
ColonelPhorbin: folds
iknewyouhadit: folds
CharlieM84: folds
rkinney64: folds
dnagel222: calls $1
jack wipe7: checks
*** FLOP *** [4c As Qs]
dnagel222: bets $2
jack wipe7: folds
Uncalled bet ($2) returned to dnagel222
dnagel222 collected $3.80 from pot
*** SUMMARY ***
Total pot $4 | Rake $0.20
Board [4c As Qs]
Seat 1: iknewyouhadit folded before Flop (didn't bet)
Seat 2: CharlieM84 folded before Flop (didn't bet)
Seat 3: rkinney64 (button) folded before Flop (didn't bet)
Seat 4: dnagel222 (small blind) collected ($3.80)
Seat 5: jack wipe7 (big blind) folded on the Flop
Seat 6: ColonelPhorbin folded before Flop (didn't bet)


PokerStars Hand #232991997699:  Hold'em No Limit ($1/$2 USD) - 2022/01/16 11:37:03 ET
Table 'Atalante' 6-max Seat #4 is the button
Seat 1: iknewyouhadit ($213.30 in chips)
Seat 2: CharlieM84 ($403.80 in chips)
Seat 3: rkinney64 ($145.96 in chips)
Seat 4: dnagel222 ($88.10 in chips)
Seat 5: jack wipe7 ($85.05 in chips)
Seat 6: ColonelPhorbin ($194 in chips)
jack wipe7: posts small blind $1
ColonelPhorbin: posts big blind $2
*** HOLE CARDS ***
iknewyouhadit: folds
CharlieM84: folds
rkinney64: folds
dnagel222: folds
jack wipe7: calls $1
ColonelPhorbin: checks
*** FLOP *** [Kd Kh Jd]
jack wipe7: checks
ColonelPhorbin: bets $3.80
jack wipe7: folds
Uncalled bet ($3.80) returned to ColonelPhorbin
ColonelPhorbin collected $3.80 from pot
*** SUMMARY ***
Total pot $4 | Rake $0.20
Board [Kd Kh Jd]
Seat 1: iknewyouhadit folded before Flop (didn't bet)
Seat 2: CharlieM84 folded before Flop (didn't bet)
Seat 3: rkinney64 folded before Flop (didn't bet)
Seat 4: dnagel222 (button) folded before Flop (didn't bet)
Seat 5: jack wipe7 (small blind) folded on the Flop
Seat 6: ColonelPhorbin (big blind) collected ($3.80)


PokerStars Hand #232991997904:  Hold'em No Limit ($1/$2 USD) - 2022/01/16 11:37:42 ET
Table 'Atalante' 6-max Seat #5 is the button
Seat 1: iknewyouhadit ($213.30 in chips)
Seat 2: CharlieM84 ($403.80 in chips)
Seat 3: rkinney64 ($145.96 in chips)
Seat 4: dnagel222 ($88.10 in chips)
Seat 5: jack wipe7 ($83.05 in chips)
Seat 6: ColonelPhorbin ($195.80 in chips)
ColonelPhorbin: posts small blind $1
iknewyouhadit: posts big blind $2
*** HOLE CARDS ***
CharlieM84: folds
rkinney64: folds
dnagel222: folds
jack wipe7: folds
ColonelPhorbin: calls $1
iknewyouhadit: checks
*** FLOP *** [9c Td 8c]
ColonelPhorbin: checks
iknewyouhadit: checks
*** TURN *** [9c Td 8c] [4d]
ColonelPhorbin: checks
iknewyouhadit: checks
*** RIVER *** [9c Td 8c 4d] [Ac]
ColonelPhorbin: checks
iknewyouhadit: checks
*** SHOW DOWN ***
ColonelPhorbin: shows [6h 5h] (high card Ace)
iknewyouhadit: shows [Qh 2h] (high card Ace - Queen kicker)
iknewyouhadit collected $3.80 from pot
*** SUMMARY ***
Total pot $4 | Rake $0.20
Board [9c Td 8c 4d Ac]
Seat 1: iknewyouhadit (big blind) showed [Qh 2h] and won ($3.80) with high card Ace
Seat 2: CharlieM84 folded before Flop (didn't bet)
Seat 3: rkinney64 folded before Flop (didn't bet)
Seat 4: dnagel222 folded before Flop (didn't bet)
Seat 5: jack wipe7 (button) folded before Flop (didn't bet)
Seat 6: ColonelPhorbin (small blind) showed [6h 5h] and lost with high card Ace


PokerStars Hand #232991998139:  Hold'em No Limit ($1/$2 USD) - 2022/01/16 11:38:30 ET
Table 'Atalante' 6-max Seat #6 is the button
Seat 1: iknewyouhadit ($215.10 in chips)
Seat 2: CharlieM84 ($403.80 in chips)
Seat 3: rkinney64 ($145.96 in chips)
Seat 4: dnagel222 ($88.10 in chips)
Seat 5: jack wipe7 ($83.05 in chips)
Seat 6: ColonelPhorbin ($193.80 in chips)
iknewyouhadit: posts small blind $1
CharlieM84: posts big blind $2
*** HOLE CARDS ***
rkinney64: folds
dnagel222: folds
jack wipe7: folds
ColonelPhorbin: folds
iknewyouhadit: folds
Uncalled bet ($1) returned to CharlieM84
CharlieM84 collected $2 from pot
CharlieM84: doesn't show hand
*** SUMMARY ***
Total pot $2 | Rake $0
Seat 1: iknewyouhadit (small blind) folded before Flop
Seat 2: CharlieM84 (big blind) collected ($2)
Seat 3: rkinney64 folded before Flop (didn't bet)
Seat 4: dnagel222 folded before Flop (didn't bet)
Seat 5: jack wipe7 folded before Flop (didn't bet)
Seat 6: ColonelPhorbin (button) folded before Flop (didn't bet)


PokerStars Hand #232991998188:  Hold'em No Limit ($1/$2 USD) - 2022/01/16 11:38:40 ET
Table 'Atalante' 6-max Seat #1 is the button
Seat 1: iknewyouhadit ($214.10 in chips)
Seat 2: CharlieM84 ($404.80 in chips)
Seat 3: rkinney64 ($145.96 in chips)
Seat 4: dnagel222 ($88.10 in chips)
Seat 5: jack wipe7 ($83.05 in chips)
Seat 6: ColonelPhorbin ($193.80 in chips)
CharlieM84: posts small blind $1
rkinney64: posts big blind $2
*** HOLE CARDS ***
dnagel222: folds
jack wipe7: folds
ColonelPhorbin: raises $2 to $4
iknewyouhadit: raises $11 to $15
CharlieM84: folds
rkinney64: folds
ColonelPhorbin: calls $11
*** FLOP *** [Ah 7h Qd]
ColonelPhorbin: checks
iknewyouhadit: checks
*** TURN *** [Ah 7h Qd] [Jh]
ColonelPhorbin: bets $31.35
iknewyouhadit: folds
Uncalled bet ($31.35) returned to ColonelPhorbin
ColonelPhorbin collected $31.35 from pot
*** SUMMARY ***
Total pot $33 | Rake $1.65
Board [Ah 7h Qd Jh]
Seat 1: iknewyouhadit (button) folded on the Turn
Seat 2: CharlieM84 (small blind) folded before Flop
Seat 3: rkinney64 (big blind) folded before Flop
Seat 4: dnagel222 folded before Flop (didn't bet)
Seat 5: jack wipe7 folded before Flop (didn't bet)
Seat 6: ColonelPhorbin collected ($31.35)


PokerStars Hand #232991998390:  Hold'em No Limit ($1/$2 USD) - 2022/01/16 11:39:23 ET
Table 'Atalante' 6-max Seat #2 is the button
Seat 1: iknewyouhadit ($200 in chips)
Seat 2: CharlieM84 ($403.80 in chips)
Seat 3: rkinney64 ($143.96 in chips)
Seat 4: dnagel222 ($88.10 in chips)
Seat 5: jack wipe7 ($83.05 in chips)
Seat 6: ColonelPhorbin ($210.15 in chips)
rkinney64: posts small blind $1
dnagel222: posts big blind $2
*** HOLE CARDS ***
jack wipe7: folds
ColonelPhorbin: folds
iknewyouhadit: raises $2.60 to $4.60
CharlieM84: folds
rkinney64: folds
dnagel222: folds
Uncalled bet ($2.60) returned to iknewyouhadit
iknewyouhadit collected $5 from pot
*** SUMMARY ***
Total pot $5 | Rake $0
Seat 1: iknewyouhadit collected ($5)
Seat 2: CharlieM84 (button) folded before Flop (didn't bet)
Seat 3: rkinney64 (small blind) folded before Flop
Seat 4: dnagel222 (big blind) folded before Flop
Seat 5: jack wipe7 folded before Flop (didn't bet)
Seat 6: ColonelPhorbin folded before Flop (didn't bet)


PokerStars Hand #232991998479:  Hold'em No Limit ($1/$2 USD) - 2022/01/16 11:39:41 ET
Table 'Atalante' 6-max Seat #3 is the button
Seat 1: iknewyouhadit ($203 in chips)
Seat 2: CharlieM84 ($403.80 in chips)
Seat 3: rkinney64 ($142.96 in chips)
Seat 4: dnagel222 ($86.10 in chips)
Seat 5: jack wipe7 ($83.05 in chips)
Seat 6: ColonelPhorbin ($210.15 in chips)
dnagel222: posts small blind $1
jack wipe7: posts big blind $2
*** HOLE CARDS ***
ColonelPhorbin: folds
iknewyouhadit: folds
CharlieM84: folds
rkinney64: folds
dnagel222: calls $1
jack wipe7: checks
*** FLOP *** [5c Ah Jh]
dnagel222: bets $2
jack wipe7: calls $2
*** TURN *** [5c Ah Jh] [3c]
dnagel222: bets $2
jack wipe7: raises $6 to $8
dnagel222: calls $6
*** RIVER *** [5c Ah Jh 3c] [Qd]
dnagel222: checks
jack wipe7: checks
*** SHOW DOWN ***
dnagel222: shows [As 2d] (a pair of Aces)
jack wipe7: mucks hand
dnagel222 collected $22.80 from pot
*** SUMMARY ***
Total pot $24 | Rake $1.20
Board [5c Ah Jh 3c Qd]
Seat 1: iknewyouhadit folded before Flop (didn't bet)
Seat 2: CharlieM84 folded before Flop (didn't bet)
Seat 3: rkinney64 (button) folded before Flop (didn't bet)
Seat 4: dnagel222 (small blind) showed [As 2d] and won ($22.80) with a pair of Aces
Seat 5: jack wipe7 (big blind) mucked
Seat 6: ColonelPhorbin folded before Flop (didn't bet)


PokerStars Hand #232991998775:  Hold'em No Limit ($1/$2 USD) - 2022/01/16 11:40:41 ET
Table 'Atalante' 6-max Seat #4 is the button
Seat 1: iknewyouhadit ($203 in chips)
Seat 2: CharlieM84 ($403.80 in chips)
Seat 3: rkinney64 ($142.96 in chips)
Seat 4: dnagel222 ($96.90 in chips)
Seat 5: jack wipe7 ($71.05 in chips)
Seat 6: ColonelPhorbin ($210.15 in chips)
jack wipe7: posts small blind $1
ColonelPhorbin: posts big blind $2
*** HOLE CARDS ***
iknewyouhadit: folds
CharlieM84: folds
rkinney64: folds
dnagel222: folds
jack wipe7: calls $1
ColonelPhorbin: checks
*** FLOP *** [Jd 6c 2h]
jack wipe7: bets $2
ColonelPhorbin: folds
Uncalled bet ($2) returned to jack wipe7
jack wipe7 collected $3.80 from pot
jack wipe7: doesn't show hand
*** SUMMARY ***
Total pot $4 | Rake $0.20
Board [Jd 6c 2h]
Seat 1: iknewyouhadit folded before Flop (didn't bet)
Seat 2: CharlieM84 folded before Flop (didn't bet)
Seat 3: rkinney64 folded before Flop (didn't bet)
Seat 4: dnagel222 (button) folded before Flop (didn't bet)
Seat 5: jack wipe7 (small blind) collected ($3.80)
Seat 6: ColonelPhorbin (big blind) folded on the Flop


PokerStars Hand #232991998867:  Hold'em No Limit ($1/$2 USD) - 2022/01/16 11:41:01 ET
Table 'Atalante' 6-max Seat #5 is the button
Seat 1: iknewyouhadit ($203 in chips)
Seat 2: CharlieM84 ($403.80 in chips)
Seat 3: rkinney64 ($142.96 in chips)
Seat 4: dnagel222 ($96.90 in chips)
Seat 5: jack wipe7 ($72.85 in chips)
Seat 6: ColonelPhorbin ($208.15 in chips)
ColonelPhorbin: posts small blind $1
iknewyouhadit: posts big blind $2
*** HOLE CARDS ***
CharlieM84: folds
rkinney64: folds
dnagel222 has timed out
dnagel222: folds
jack wipe7: folds
ColonelPhorbin: calls $1
iknewyouhadit: raises $6 to $8
ColonelPhorbin: folds
Uncalled bet ($6) returned to iknewyouhadit
iknewyouhadit collected $4 from pot
*** SUMMARY ***
Total pot $4 | Rake $0
Seat 1: iknewyouhadit (big blind) collected ($4)
Seat 2: CharlieM84 folded before Flop (didn't bet)
Seat 3: rkinney64 folded before Flop (didn't bet)
Seat 4: dnagel222 folded before Flop (didn't bet)
Seat 5: jack wipe7 (button) folded before Flop (didn't bet)
Seat 6: ColonelPhorbin (small blind) folded before Flop


PokerStars Hand #232991999066:  Hold'em No Limit ($1/$2 USD) - 2022/01/16 11:41:40 ET
Table 'Atalante' 6-max Seat #6 is the button
Seat 1: iknewyouhadit ($205 in chips)
Seat 2: CharlieM84 ($403.80 in chips)
Seat 3: rkinney64 ($142.96 in chips)
Seat 5: jack wipe7 ($72.85 in chips)
Seat 6: ColonelPhorbin ($206.15 in chips)
iknewyouhadit: posts small blind $1
CharlieM84: posts big blind $2
*** HOLE CARDS ***
rkinney64: folds
jack wipe7: raises $4 to $6
ColonelPhorbin: calls $6
iknewyouhadit: folds
CharlieM84: folds
*** FLOP *** [Kc 3s Ts]
jack wipe7: bets $8
ColonelPhorbin: folds
Uncalled bet ($8) returned to jack wipe7
jack wipe7 collected $14.25 from pot
jack wipe7: doesn't show hand
*** SUMMARY ***
Total pot $15 | Rake $0.75
Board [Kc 3s Ts]
Seat 1: iknewyouhadit (small blind) folded before Flop
Seat 2: CharlieM84 (big blind) folded before Flop
Seat 3: rkinney64 folded before Flop (didn't bet)
Seat 5: jack wipe7 collected ($14.25)
Seat 6: ColonelPhorbin (button) folded on the Flop


PokerStars Hand #232991999241:  Hold'em No Limit ($1/$2 USD) - 2022/01/16 11:42:16 ET
Table 'Atalante' 6-max Seat #1 is the button
Seat 1: iknewyouhadit ($204 in chips)
Seat 2: CharlieM84 ($401.80 in chips)
Seat 3: rkinney64 ($142.96 in chips)
Seat 5: jack wipe7 ($81.10 in chips)
Seat 6: ColonelPhorbin ($200.15 in chips)
CharlieM84: posts small blind $1
rkinney64: posts big blind $2
*** HOLE CARDS ***
jack wipe7: calls $2
ColonelPhorbin: folds
iknewyouhadit: folds
CharlieM84: calls $1
rkinney64: checks
*** FLOP *** [8c 9d Ts]
CharlieM84: checks
rkinney64: checks
jack wipe7: bets $4
CharlieM84: folds
rkinney64: folds
Uncalled bet ($4) returned to jack wipe7
jack wipe7 collected $5.70 from pot
jack wipe7: doesn't show hand
*** SUMMARY ***
Total pot $6 | Rake $0.30
Board [8c 9d Ts]
Seat 1: iknewyouhadit (button) folded before Flop (didn't bet)
Seat 2: CharlieM84 (small blind) folded on the Flop
Seat 3: rkinney64 (big blind) folded on the Flop
Seat 5: jack wipe7 collected ($5.70)
Seat 6: ColonelPhorbin folded before Flop (didn't bet)


PokerStars Hand #232991999412:  Hold'em No Limit ($1/$2 USD) - 2022/01/16 11:42:51 ET
Table 'Atalante' 6-max Seat #2 is the button
Seat 1: iknewyouhadit ($204 in chips)
Seat 2: CharlieM84 ($399.80 in chips)
Seat 3: rkinney64 ($140.96 in chips)
Seat 4: dnagel222 ($96.90 in chips)
Seat 5: jack wipe7 ($84.80 in chips)
Seat 6: ColonelPhorbin ($200.15 in chips)
rkinney64: posts small blind $1
dnagel222: posts big blind $2
*** HOLE CARDS ***
jack wipe7: folds
ColonelPhorbin: folds
iknewyouhadit: folds
CharlieM84: folds
rkinney64: calls $1
dnagel222: checks
*** FLOP *** [4d 4h Td]
rkinney64: bets $6
dnagel222: folds
Uncalled bet ($6) returned to rkinney64
rkinney64 collected $3.80 from pot
rkinney64: doesn't show hand
*** SUMMARY ***
Total pot $4 | Rake $0.20
Board [4d 4h Td]
Seat 1: iknewyouhadit folded before Flop (didn't bet)
Seat 2: CharlieM84 (button) folded before Flop (didn't bet)
Seat 3: rkinney64 (small blind) collected ($3.80)
Seat 4: dnagel222 (big blind) folded on the Flop
Seat 5: jack wipe7 folded before Flop (didn't bet)
Seat 6: ColonelPhorbin folded before Flop (didn't bet)


PokerStars Hand #232991999599:  Hold'em No Limit ($1/$2 USD) - 2022/01/16 11:43:22 ET
Table 'Atalante' 6-max Seat #3 is the button
Seat 1: iknewyouhadit ($204 in chips)
Seat 2: CharlieM84 ($399.80 in chips)
Seat 3: rkinney64 ($142.76 in chips)
Seat 4: dnagel222 ($94.90 in chips)
Seat 5: jack wipe7 ($84.80 in chips)
Seat 6: ColonelPhorbin ($200.15 in chips)
dnagel222: posts small blind $1
jack wipe7: posts big blind $2
*** HOLE CARDS ***
ColonelPhorbin: folds
iknewyouhadit: folds
CharlieM84: folds
rkinney64: folds
dnagel222: calls $1
jack wipe7: raises $4 to $6
dnagel222: folds
Uncalled bet ($4) returned to jack wipe7
jack wipe7 collected $4 from pot
jack wipe7: doesn't show hand
*** SUMMARY ***
Total pot $4 | Rake $0
Seat 1: iknewyouhadit folded before Flop (didn't bet)
Seat 2: CharlieM84 folded before Flop (didn't bet)
Seat 3: rkinney64 (button) folded before Flop (didn't bet)
Seat 4: dnagel222 (small blind) folded before Flop
Seat 5: jack wipe7 (big blind) collected ($4)
Seat 6: ColonelPhorbin folded before Flop (didn't bet)


PokerStars Hand #232991999702:  Hold'em No Limit ($1/$2 USD) - 2022/01/16 11:43:43 ET
Table 'Atalante' 6-max Seat #4 is the button
Seat 1: iknewyouhadit ($204 in chips)
Seat 2: CharlieM84 ($399.80 in chips)
Seat 3: rkinney64 ($142.76 in chips)
Seat 4: dnagel222 ($92.90 in chips)
Seat 5: jack wipe7 ($86.80 in chips)
Seat 6: ColonelPhorbin ($200.15 in chips)
jack wipe7: posts small blind $1
ColonelPhorbin: posts big blind $2
*** HOLE CARDS ***
iknewyouhadit: folds
CharlieM84: folds
rkinney64: raises $4 to $6
dnagel222: folds
jack wipe7: calls $5
ColonelPhorbin: calls $4
*** FLOP *** [3d 2h 5c]
jack wipe7: checks
ColonelPhorbin: checks
rkinney64: checks
*** TURN *** [3d 2h 5c] [6h]
jack wipe7: checks
ColonelPhorbin: bets $8.55
rkinney64: folds
jack wipe7: folds
Uncalled bet ($8.55) returned to ColonelPhorbin
ColonelPhorbin collected $17.10 from pot
*** SUMMARY ***
Total pot $18 | Rake $0.90
Board [3d 2h 5c 6h]
Seat 1: iknewyouhadit folded before Flop (didn't bet)
Seat 2: CharlieM84 folded before Flop (didn't bet)
Seat 3: rkinney64 folded on the Turn
Seat 4: dnagel222 (button) folded before Flop (didn't bet)
Seat 5: jack wipe7 (small blind) folded on the Turn
Seat 6: ColonelPhorbin (big blind) collected ($17.10)


PokerStars Hand #232991999977:  Hold'em No Limit ($1/$2 USD) - 2022/01/16 11:44:33 ET
Table 'Atalante' 6-max Seat #5 is the button
Seat 1: iknewyouhadit ($204 in chips)
Seat 2: CharlieM84 ($399.80 in chips)
Seat 3: rkinney64 ($136.76 in chips)
Seat 4: dnagel222 ($92.90 in chips)
Seat 5: jack wipe7 ($80.80 in chips)
Seat 6: ColonelPhorbin ($211.25 in chips)
ColonelPhorbin: posts small blind $1
iknewyouhadit: posts big blind $2
*** HOLE CARDS ***
CharlieM84: folds
rkinney64: folds
dnagel222: folds
jack wipe7: folds
ColonelPhorbin: calls $1
iknewyouhadit: raises $6 to $8
ColonelPhorbin: folds
Uncalled bet ($6) returned to iknewyouhadit
iknewyouhadit collected $4 from pot
*** SUMMARY ***
Total pot $4 | Rake $0
Seat 1: iknewyouhadit (big blind) collected ($4)
Seat 2: CharlieM84 folded before Flop (didn't bet)
Seat 3: rkinney64 folded before Flop (didn't bet)
Seat 4: dnagel222 folded before Flop (didn't bet)
Seat 5: jack wipe7 (button) folded before Flop (didn't bet)
Seat 6: ColonelPhorbin (small blind) folded before Flop


PokerStars Hand #232992203582:  Hold'em No Limit ($1/$2 USD) - 2022/01/16 11:44:53 ET
Table 'Atalante' 6-max Seat #6 is the button
Seat 1: iknewyouhadit ($206 in chips)
Seat 2: CharlieM84 ($399.80 in chips)
Seat 3: rkinney64 ($136.76 in chips)
Seat 4: dnagel222 ($92.90 in chips)
Seat 5: jack wipe7 ($80.80 in chips)
Seat 6: ColonelPhorbin ($209.25 in chips)
iknewyouhadit: posts small blind $1
CharlieM84: posts big blind $2
*** HOLE CARDS ***
rkinney64: folds
dnagel222: folds
jack wipe7: folds
ColonelPhorbin: raises $2 to $4
iknewyouhadit: calls $3
CharlieM84: calls $2
*** FLOP *** [9h Qd 8h]
iknewyouhadit: checks
CharlieM84: checks
ColonelPhorbin: bets $5.70
iknewyouhadit: folds
CharlieM84: folds
Uncalled bet ($5.70) returned to ColonelPhorbin
ColonelPhorbin collected $11.40 from pot
*** SUMMARY ***
Total pot $12 | Rake $0.60
Board [9h Qd 8h]
Seat 1: iknewyouhadit (small blind) folded on the Flop
Seat 2: CharlieM84 (big blind) folded on the Flop
Seat 3: rkinney64 folded before Flop (didn't bet)
Seat 4: dnagel222 folded before Flop (didn't bet)
Seat 5: jack wipe7 folded before Flop (didn't bet)
Seat 6: ColonelPhorbin (button) collected ($11.40)


PokerStars Hand #232992203904:  Hold'em No Limit ($1/$2 USD) - 2022/01/16 11:45:57 ET
Table 'Atalante' 6-max Seat #1 is the button
Seat 1: iknewyouhadit ($202 in chips)
Seat 2: CharlieM84 ($395.80 in chips)
Seat 3: rkinney64 ($136.76 in chips)
Seat 4: dnagel222 ($92.90 in chips)
Seat 5: jack wipe7 ($80.80 in chips)
Seat 6: ColonelPhorbin ($216.65 in chips)
CharlieM84: posts small blind $1
rkinney64: posts big blind $2
*** HOLE CARDS ***
dnagel222: folds
jack wipe7: folds
ColonelPhorbin: folds
iknewyouhadit: folds
CharlieM84: folds
Uncalled bet ($1) returned to rkinney64
rkinney64 collected $2 from pot
rkinney64: doesn't show hand
*** SUMMARY ***
Total pot $2 | Rake $0
Seat 1: iknewyouhadit (button) folded before Flop (didn't bet)
Seat 2: CharlieM84 (small blind) folded before Flop
Seat 3: rkinney64 (big blind) collected ($2)
Seat 4: dnagel222 folded before Flop (didn't bet)
Seat 5: jack wipe7 folded before Flop (didn't bet)
Seat 6: ColonelPhorbin folded before Flop (didn't bet)


PokerStars Hand #232992203964:  Hold'em No Limit ($1/$2 USD) - 2022/01/16 11:46:10 ET
Table 'Atalante' 6-max Seat #2 is the button
Seat 1: iknewyouhadit ($202 in chips)
Seat 2: CharlieM84 ($394.80 in chips)
Seat 3: rkinney64 ($137.76 in chips)
Seat 4: dnagel222 ($92.90 in chips)
Seat 5: jack wipe7 ($80.80 in chips)
Seat 6: ColonelPhorbin ($216.65 in chips)
rkinney64: posts small blind $1
dnagel222: posts big blind $2
*** HOLE CARDS ***
jack wipe7: folds
ColonelPhorbin has timed out
ColonelPhorbin: folds
iknewyouhadit: raises $2.60 to $4.60
CharlieM84: folds
rkinney64: folds
dnagel222: folds
Uncalled bet ($2.60) returned to iknewyouhadit
iknewyouhadit collected $5 from pot
*** SUMMARY ***
Total pot $5 | Rake $0
Seat 1: iknewyouhadit collected ($5)
Seat 2: CharlieM84 (button) folded before Flop (didn't bet)
Seat 3: rkinney64 (small blind) folded before Flop
Seat 4: dnagel222 (big blind) folded before Flop
Seat 5: jack wipe7 folded before Flop (didn't bet)
Seat 6: ColonelPhorbin folded before Flop (didn't bet)


PokerStars Hand #232992204153:  Hold'em No Limit ($1/$2 USD) - 2022/01/16 11:46:52 ET
Table 'Atalante' 6-max Seat #3 is the button
Seat 1: iknewyouhadit ($205 in chips)
Seat 2: CharlieM84 ($394.80 in chips)
Seat 3: rkinney64 ($136.76 in chips)
Seat 4: dnagel222 ($90.90 in chips)
Seat 5: jack wipe7 ($80.80 in chips)
Seat 6: ColonelPhorbin ($216.65 in chips)
dnagel222: posts small blind $1
jack wipe7: posts big blind $2
*** HOLE CARDS ***
ColonelPhorbin: calls $2
iknewyouhadit: folds
CharlieM84: folds
rkinney64: calls $2
dnagel222: folds
jack wipe7: checks
*** FLOP *** [Qd Kd 7c]
jack wipe7: checks
ColonelPhorbin: bets $2
rkinney64: folds
jack wipe7: calls $2
*** TURN *** [Qd Kd 7c] [7s]
jack wipe7: bets $8
ColonelPhorbin: calls $8
*** RIVER *** [Qd Kd 7c 7s] [Th]
jack wipe7: bets $12
ColonelPhorbin: folds
Uncalled bet ($12) returned to jack wipe7
jack wipe7 collected $25.65 from pot
jack wipe7: doesn't show hand
*** SUMMARY ***
Total pot $27 | Rake $1.35
Board [Qd Kd 7c 7s Th]
Seat 1: iknewyouhadit folded before Flop (didn't bet)
Seat 2: CharlieM84 folded before Flop (didn't bet)
Seat 3: rkinney64 (button) folded on the Flop
Seat 4: dnagel222 (small blind) folded before Flop
Seat 5: jack wipe7 (big blind) collected ($25.65)
Seat 6: ColonelPhorbin folded on the River


PokerStars Hand #232992204408:  Hold'em No Limit ($1/$2 USD) - 2022/01/16 11:47:51 ET
Table 'Atalante' 6-max Seat #4 is the button
Seat 1: iknewyouhadit ($205 in chips)
Seat 2: CharlieM84 ($394.80 in chips)
Seat 3: rkinney64 ($134.76 in chips)
Seat 4: dnagel222 ($89.90 in chips)
Seat 5: jack wipe7 ($94.45 in chips)
Seat 6: ColonelPhorbin ($204.65 in chips)
jack wipe7: posts small blind $1
ColonelPhorbin: posts big blind $2
*** HOLE CARDS ***
iknewyouhadit: folds
CharlieM84: raises $3 to $5
rkinney64: folds
dnagel222: folds
jack wipe7: folds
ColonelPhorbin: folds
Uncalled bet ($3) returned to CharlieM84
CharlieM84 collected $5 from pot
CharlieM84: doesn't show hand
*** SUMMARY ***
Total pot $5 | Rake $0
Seat 1: iknewyouhadit folded before Flop (didn't bet)
Seat 2: CharlieM84 collected ($5)
Seat 3: rkinney64 folded before Flop (didn't bet)
Seat 4: dnagel222 (button) folded before Flop (didn't bet)
Seat 5: jack wipe7 (small blind) folded before Flop
Seat 6: ColonelPhorbin (big blind) folded before Flop


PokerStars Hand #232992204498:  Hold'em No Limit ($1/$2 USD) - 2022/01/16 11:48:09 ET
Table 'Atalante' 6-max Seat #5 is the button
Seat 1: iknewyouhadit ($205 in chips)
Seat 2: CharlieM84 ($397.80 in chips)
Seat 3: rkinney64 ($134.76 in chips)
Seat 4: dnagel222 ($89.90 in chips)
Seat 5: jack wipe7 ($93.45 in chips)
Seat 6: ColonelPhorbin ($202.65 in chips)
ColonelPhorbin: posts small blind $1
iknewyouhadit: posts big blind $2
*** HOLE CARDS ***
CharlieM84: folds
rkinney64: folds
dnagel222: calls $2
jack wipe7: raises $6 to $8
ColonelPhorbin: folds
iknewyouhadit: folds
dnagel222: folds
Uncalled bet ($6) returned to jack wipe7
jack wipe7 collected $7 from pot
jack wipe7: doesn't show hand
*** SUMMARY ***
Total pot $7 | Rake $0
Seat 1: iknewyouhadit (big blind) folded before Flop
Seat 2: CharlieM84 folded before Flop (didn't bet)
Seat 3: rkinney64 folded before Flop (didn't bet)
Seat 4: dnagel222 folded before Flop
Seat 5: jack wipe7 (button) collected ($7)
Seat 6: ColonelPhorbin (small blind) folded before Flop


PokerStars Hand #232992204622:  Hold'em No Limit ($1/$2 USD) - 2022/01/16 11:48:38 ET
Table 'Atalante' 6-max Seat #6 is the button
Seat 1: iknewyouhadit ($203 in chips)
Seat 3: rkinney64 ($134.76 in chips)
Seat 4: dnagel222 ($87.90 in chips)
Seat 5: jack wipe7 ($98.45 in chips)
Seat 6: ColonelPhorbin ($201.65 in chips)
iknewyouhadit: posts small blind $1
CharlieM84: is sitting out
rkinney64: posts big blind $2
*** HOLE CARDS ***
dnagel222: folds
jack wipe7: calls $2
ColonelPhorbin: raises $2 to $4
iknewyouhadit: folds
rkinney64: calls $2
jack wipe7: calls $2
*** FLOP *** [Qh Js Kc]
rkinney64: checks
jack wipe7: checks
ColonelPhorbin: bets $12.35
rkinney64: folds
jack wipe7: folds
Uncalled bet ($12.35) returned to ColonelPhorbin
ColonelPhorbin collected $12.35 from pot
*** SUMMARY ***
Total pot $13 | Rake $0.65
Board [Qh Js Kc]
Seat 1: iknewyouhadit (small blind) folded before Flop
Seat 3: rkinney64 (big blind) folded on the Flop
Seat 4: dnagel222 folded before Flop (didn't bet)
Seat 5: jack wipe7 folded on the Flop
Seat 6: ColonelPhorbin (button) collected ($12.35)


PokerStars Hand #232992204844:  Hold'em No Limit ($1/$2 USD) - 2022/01/16 11:49:28 ET
Table 'Atalante' 6-max Seat #1 is the button
Seat 1: iknewyouhadit ($202 in chips)
Seat 3: rkinney64 ($130.76 in chips)
Seat 4: dnagel222 ($87.90 in chips)
Seat 5: jack wipe7 ($94.45 in chips)
Seat 6: ColonelPhorbin ($210 in chips)
rkinney64: posts small blind $1
dnagel222: posts big blind $2
*** HOLE CARDS ***
jack wipe7: folds
ColonelPhorbin: raises $2 to $4
iknewyouhadit: folds
rkinney64: calls $3
dnagel222: folds
*** FLOP *** [Ac Js 7h]
rkinney64: bets $6
ColonelPhorbin: calls $6
*** TURN *** [Ac Js 7h] [6c]
rkinney64: bets $6
ColonelPhorbin: calls $6
*** RIVER *** [Ac Js 7h 6c] [6h]
rkinney64: bets $34
ColonelPhorbin: raises $34 to $68
rkinney64: raises $46.76 to $114.76 and is all-in
ColonelPhorbin: calls $46.76
*** SHOW DOWN ***
rkinney64: shows [Ah 6s] (a full house, Sixes full of Aces)
ColonelPhorbin: shows [As Jd] (two pair, Aces and Jacks)
rkinney64 collected $260.52 from pot
*** SUMMARY ***
Total pot $263.52 | Rake $3
Board [Ac Js 7h 6c 6h]
Seat 1: iknewyouhadit (button) folded before Flop (didn't bet)
Seat 3: rkinney64 (small blind) showed [Ah 6s] and won ($260.52) with a full house, Sixes full of Aces
Seat 4: dnagel222 (big blind) folded before Flop
Seat 5: jack wipe7 folded before Flop (didn't bet)
Seat 6: ColonelPhorbin showed [As Jd] and lost with two pair, Aces and Jacks


PokerStars Hand #232992205142:  Hold'em No Limit ($1/$2 USD) - 2022/01/16 11:50:33 ET
Table 'Atalante' 6-max Seat #3 is the button
Seat 1: iknewyouhadit ($202 in chips)
Seat 3: rkinney64 ($260.52 in chips)
Seat 4: dnagel222 ($85.90 in chips)
Seat 5: jack wipe7 ($94.45 in chips)
Seat 6: ColonelPhorbin ($79.24 in chips)
dnagel222: posts small blind $1
jack wipe7: posts big blind $2
*** HOLE CARDS ***
ColonelPhorbin: calls $2
iknewyouhadit: folds
rkinney64: folds
dnagel222: folds
jack wipe7: checks
*** FLOP *** [3d 9d 4c]
jack wipe7: checks
ColonelPhorbin: bets $2.38
jack wipe7: calls $2.38
*** TURN *** [3d 9d 4c] [Th]
jack wipe7: checks
ColonelPhorbin: checks
*** RIVER *** [3d 9d 4c Th] [9c]
jack wipe7: bets $6
ColonelPhorbin: calls $6
*** SHOW DOWN ***
jack wipe7: shows [6s 5d] (a pair of Nines)
ColonelPhorbin: shows [Ac 3h] (two pair, Nines and Threes)
ColonelPhorbin collected $20.67 from pot
*** SUMMARY ***
Total pot $21.76 | Rake $1.09
Board [3d 9d 4c Th 9c]
Seat 1: iknewyouhadit folded before Flop (didn't bet)
Seat 3: rkinney64 (button) folded before Flop (didn't bet)
Seat 4: dnagel222 (small blind) folded before Flop
Seat 5: jack wipe7 (big blind) showed [6s 5d] and lost with a pair of Nines
Seat 6: ColonelPhorbin showed [Ac 3h] and won ($20.67) with two pair, Nines and Threes


PokerStars Hand #232992205396:  Hold'em No Limit ($1/$2 USD) - 2022/01/16 11:51:25 ET
Table 'Atalante' 6-max Seat #4 is the button
Seat 1: iknewyouhadit ($202 in chips)
Seat 3: rkinney64 ($260.52 in chips)
Seat 4: dnagel222 ($84.90 in chips)
Seat 5: jack wipe7 ($84.07 in chips)
Seat 6: ColonelPhorbin ($89.53 in chips)
jack wipe7: posts small blind $1
ColonelPhorbin: posts big blind $2
*** HOLE CARDS ***
iknewyouhadit: folds
rkinney64: calls $2
dnagel222: calls $2
jack wipe7: raises $6 to $8
ColonelPhorbin: folds
rkinney64: calls $6
dnagel222: folds
*** FLOP *** [4c 6s Th]
jack wipe7: bets $8
rkinney64: folds
Uncalled bet ($8) returned to jack wipe7
jack wipe7 collected $19 from pot
jack wipe7: doesn't show hand
*** SUMMARY ***
Total pot $20 | Rake $1
Board [4c 6s Th]
Seat 1: iknewyouhadit folded before Flop (didn't bet)
Seat 3: rkinney64 folded on the Flop
Seat 4: dnagel222 (button) folded before Flop
Seat 5: jack wipe7 (small blind) collected ($19)
Seat 6: ColonelPhorbin (big blind) folded before Flop


PokerStars Hand #232992205586:  Hold'em No Limit ($1/$2 USD) - 2022/01/16 11:52:06 ET
Table 'Atalante' 6-max Seat #5 is the button
Seat 1: iknewyouhadit ($202 in chips)
Seat 3: rkinney64 ($252.52 in chips)
Seat 4: dnagel222 ($82.90 in chips)
Seat 5: jack wipe7 ($95.07 in chips)
Seat 6: ColonelPhorbin ($87.53 in chips)
ColonelPhorbin: posts small blind $1
iknewyouhadit: posts big blind $2
CharlieM84: sits out
*** HOLE CARDS ***
rkinney64: calls $2
dnagel222: folds
jack wipe7: raises $4 to $6
ColonelPhorbin: calls $5
iknewyouhadit: folds
rkinney64: calls $4
*** FLOP *** [2s 2c Qc]
ColonelPhorbin: checks
rkinney64: checks
jack wipe7: bets $4
ColonelPhorbin: folds
rkinney64: folds
Uncalled bet ($4) returned to jack wipe7
jack wipe7 collected $19 from pot
jack wipe7: doesn't show hand
*** SUMMARY ***
Total pot $20 | Rake $1
Board [2s 2c Qc]
Seat 1: iknewyouhadit (big blind) folded before Flop
Seat 3: rkinney64 folded on the Flop
Seat 4: dnagel222 folded before Flop (didn't bet)
Seat 5: jack wipe7 (button) collected ($19)
Seat 6: ColonelPhorbin (small blind) folded on the Flop


PokerStars Hand #232992205860:  Hold'em No Limit ($1/$2 USD) - 2022/01/16 11:53:03 ET
Table 'Atalante' 6-max Seat #6 is the button
Seat 1: iknewyouhadit ($200 in chips)
Seat 2: CharlieM84 ($397.80 in chips)
Seat 3: rkinney64 ($246.52 in chips)
Seat 4: dnagel222 ($82.90 in chips)
Seat 5: jack wipe7 ($108.07 in chips)
Seat 6: ColonelPhorbin ($81.53 in chips)
iknewyouhadit: posts small blind $1
CharlieM84: posts big blind $2
*** HOLE CARDS ***
rkinney64: calls $2
dnagel222: folds
jack wipe7: folds
ColonelPhorbin: calls $2
iknewyouhadit: raises $8 to $10
CharlieM84: folds
rkinney64: folds
ColonelPhorbin: folds
Uncalled bet ($8) returned to iknewyouhadit
iknewyouhadit collected $8 from pot
*** SUMMARY ***
Total pot $8 | Rake $0
Seat 1: iknewyouhadit (small blind) collected ($8)
Seat 2: CharlieM84 (big blind) folded before Flop
Seat 3: rkinney64 folded before Flop
Seat 4: dnagel222 folded before Flop (didn't bet)
Seat 5: jack wipe7 folded before Flop (didn't bet)
Seat 6: ColonelPhorbin (button) folded before Flop


PokerStars Hand #232992206070:  Hold'em No Limit ($1/$2 USD) - 2022/01/16 11:53:50 ET
Table 'Atalante' 6-max Seat #1 is the button
Seat 1: iknewyouhadit ($206 in chips)
Seat 2: CharlieM84 ($395.80 in chips)
Seat 3: rkinney64 ($244.52 in chips)
Seat 5: jack wipe7 ($108.07 in chips)
Seat 6: ColonelPhorbin ($79.53 in chips)
CharlieM84: posts small blind $1
rkinney64: posts big blind $2
*** HOLE CARDS ***
jack wipe7: raises $4 to $6
ColonelPhorbin: calls $6
iknewyouhadit: folds
CharlieM84: folds
rkinney64: folds
*** FLOP *** [6c 8d 9d]
jack wipe7: bets $11.12
ColonelPhorbin: folds
Uncalled bet ($11.12) returned to jack wipe7
jack wipe7 collected $14.25 from pot
jack wipe7: doesn't show hand
*** SUMMARY ***
Total pot $15 | Rake $0.75
Board [6c 8d 9d]
Seat 1: iknewyouhadit (button) folded before Flop (didn't bet)
Seat 2: CharlieM84 (small blind) folded before Flop
Seat 3: rkinney64 (big blind) folded before Flop
Seat 5: jack wipe7 collected ($14.25)
Seat 6: ColonelPhorbin folded on the Flop


PokerStars Hand #232992206305:  Hold'em No Limit ($1/$2 USD) - 2022/01/16 11:54:44 ET
Table 'Atalante' 6-max Seat #2 is the button
Seat 1: iknewyouhadit ($206 in chips)
Seat 2: CharlieM84 ($394.80 in chips)
Seat 3: rkinney64 ($242.52 in chips)
Seat 5: jack wipe7 ($116.32 in chips)
Seat 6: ColonelPhorbin ($73.53 in chips)
rkinney64: posts small blind $1
jack wipe7: posts big blind $2
*** HOLE CARDS ***
ColonelPhorbin: calls $2
iknewyouhadit: folds
CharlieM84: folds
rkinney64: folds
jack wipe7: checks
*** FLOP *** [9d Qc Kd]
jack wipe7: checks
ColonelPhorbin: checks
*** TURN *** [9d Qc Kd] [As]
jack wipe7: checks
ColonelPhorbin: checks
*** RIVER *** [9d Qc Kd As] [Th]
jack wipe7: bets $4
ColonelPhorbin: calls $4
*** SHOW DOWN ***
jack wipe7: shows [Ad 3d] (a pair of Aces)
ColonelPhorbin: mucks hand
jack wipe7 collected $12.35 from pot
*** SUMMARY ***
Total pot $13 | Rake $0.65
Board [9d Qc Kd As Th]
Seat 1: iknewyouhadit folded before Flop (didn't bet)
Seat 2: CharlieM84 (button) folded before Flop (didn't bet)
Seat 3: rkinney64 (small blind) folded before Flop
Seat 5: jack wipe7 (big blind) showed [Ad 3d] and won ($12.35) with a pair of Aces
Seat 6: ColonelPhorbin mucked


PokerStars Hand #232992206518:  Hold'em No Limit ($1/$2 USD) - 2022/01/16 11:55:30 ET
Table 'Atalante' 6-max Seat #3 is the button
Seat 1: iknewyouhadit ($206 in chips)
Seat 2: CharlieM84 ($394.80 in chips)
Seat 3: rkinney64 ($241.52 in chips)
Seat 5: jack wipe7 ($122.67 in chips)
Seat 6: ColonelPhorbin ($67.53 in chips)
jack wipe7: posts small blind $1
ColonelPhorbin: posts big blind $2
*** HOLE CARDS ***
iknewyouhadit: folds
CharlieM84: folds
rkinney64: folds
jack wipe7: raises $4 to $6
ColonelPhorbin: calls $4
*** FLOP *** [2s 3c 8h]
jack wipe7: checks
ColonelPhorbin: checks
*** TURN *** [2s 3c 8h] [2h]
jack wipe7: bets $4
ColonelPhorbin: calls $4
*** RIVER *** [2s 3c 8h 2h] [Kc]
jack wipe7: checks
ColonelPhorbin: bets $10
jack wipe7: calls $10
*** SHOW DOWN ***
ColonelPhorbin: shows [Ah Qd] (a pair of Deuces)
jack wipe7: shows [Js Ks] (two pair, Kings and Deuces)
jack wipe7 collected $38 from pot
*** SUMMARY ***
Total pot $40 | Rake $2
Board [2s 3c 8h 2h Kc]
Seat 1: iknewyouhadit folded before Flop (didn't bet)
Seat 2: CharlieM84 folded before Flop (didn't bet)
Seat 3: rkinney64 (button) folded before Flop (didn't bet)
Seat 5: jack wipe7 (small blind) showed [Js Ks] and won ($38) with two pair, Kings and Deuces
Seat 6: ColonelPhorbin (big blind) showed [Ah Qd] and lost with a pair of Deuces


PokerStars Hand #232992206707:  Hold'em No Limit ($1/$2 USD) - 2022/01/16 11:56:16 ET
Table 'Atalante' 6-max Seat #5 is the button
Seat 1: iknewyouhadit ($206 in chips)
Seat 2: CharlieM84 ($394.80 in chips)
Seat 3: rkinney64 ($241.52 in chips)
Seat 5: jack wipe7 ($140.67 in chips)
Seat 6: ColonelPhorbin ($47.53 in chips)
ColonelPhorbin: posts small blind $1
iknewyouhadit: posts big blind $2
*** HOLE CARDS ***
CharlieM84: raises $3 to $5
rkinney64: folds
jack wipe7: folds
ColonelPhorbin: calls $4
iknewyouhadit: calls $3
*** FLOP *** [Js Jc 4s]
ColonelPhorbin: checks
iknewyouhadit: checks
CharlieM84: checks
*** TURN *** [Js Jc 4s] [5c]
ColonelPhorbin: bets $7.13
iknewyouhadit: calls $7.13
CharlieM84: folds
*** RIVER *** [Js Jc 4s 5c] [3c]
ColonelPhorbin: bets $27.80
iknewyouhadit: calls $27.80
*** SHOW DOWN ***
ColonelPhorbin: shows [Ac 6h] (a pair of Jacks)
iknewyouhadit: shows [8d Jd] (three of a kind, Jacks)
iknewyouhadit collected $81.86 from pot
*** SUMMARY ***
Total pot $84.86 | Rake $3
Board [Js Jc 4s 5c 3c]
Seat 1: iknewyouhadit (big blind) showed [8d Jd] and won ($81.86) with three of a kind, Jacks
Seat 2: CharlieM84 folded on the Turn
Seat 3: rkinney64 folded before Flop (didn't bet)
Seat 5: jack wipe7 (button) folded before Flop (didn't bet)
Seat 6: ColonelPhorbin (small blind) showed [Ac 6h] and lost with a pair of Jacks


PokerStars Hand #232992206985:  Hold'em No Limit ($1/$2 USD) - 2022/01/16 11:57:23 ET
Table 'Atalante' 6-max Seat #6 is the button
Seat 1: iknewyouhadit ($247.93 in chips)
Seat 2: CharlieM84 ($389.80 in chips)
Seat 3: rkinney64 ($241.52 in chips)
Seat 5: jack wipe7 ($140.67 in chips)
Seat 6: ColonelPhorbin ($7.60 in chips)
iknewyouhadit: posts small blind $1
CharlieM84: posts big blind $2
*** HOLE CARDS ***
rkinney64: folds
jack wipe7: folds
ColonelPhorbin: raises $5.60 to $7.60 and is all-in
iknewyouhadit: folds
CharlieM84: calls $5.60
*** FLOP *** [9h Jd 5c]
*** TURN *** [9h Jd 5c] [6h]
*** RIVER *** [9h Jd 5c 6h] [7h]
*** SHOW DOWN ***
CharlieM84: shows [8d 8c] (a straight, Five to Nine)
ColonelPhorbin: shows [Jh 3h] (a flush, Jack high)
ColonelPhorbin collected $15.39 from pot
*** SUMMARY ***
Total pot $16.20 | Rake $0.81
Board [9h Jd 5c 6h 7h]
Seat 1: iknewyouhadit (small blind) folded before Flop
Seat 2: CharlieM84 (big blind) showed [8d 8c] and lost with a straight, Five to Nine
Seat 3: rkinney64 folded before Flop (didn't bet)
Seat 5: jack wipe7 folded before Flop (didn't bet)
Seat 6: ColonelPhorbin (button) showed [Jh 3h] and won ($15.39) with a flush, Jack high


PokerStars Hand #232992207057:  Hold'em No Limit ($1/$2 USD) - 2022/01/16 11:57:40 ET
Table 'Atalante' 6-max Seat #1 is the button
Seat 1: iknewyouhadit ($246.93 in chips)
Seat 2: CharlieM84 ($382.20 in chips)
Seat 3: rkinney64 ($241.52 in chips)
Seat 5: jack wipe7 ($140.67 in chips)
Seat 6: ColonelPhorbin ($15.39 in chips)
CharlieM84: posts small blind $1
rkinney64: posts big blind $2
*** HOLE CARDS ***
jack wipe7: calls $2
ColonelPhorbin: folds
iknewyouhadit: folds
CharlieM84: folds
rkinney64: checks
*** FLOP *** [Jc Ts Ah]
rkinney64: checks
jack wipe7: bets $4
rkinney64: calls $4
*** TURN *** [Jc Ts Ah] [9c]
rkinney64: checks
jack wipe7: checks
*** RIVER *** [Jc Ts Ah 9c] [3s]
rkinney64: bets $8
jack wipe7: folds
Uncalled bet ($8) returned to rkinney64
rkinney64 collected $12.35 from pot
rkinney64: doesn't show hand
*** SUMMARY ***
Total pot $13 | Rake $0.65
Board [Jc Ts Ah 9c 3s]
Seat 1: iknewyouhadit (button) folded before Flop (didn't bet)
Seat 2: CharlieM84 (small blind) folded before Flop
Seat 3: rkinney64 (big blind) collected ($12.35)
Seat 5: jack wipe7 folded on the River
Seat 6: ColonelPhorbin folded before Flop (didn't bet)


PokerStars Hand #232992207237:  Hold'em No Limit ($1/$2 USD) - 2022/01/16 11:58:28 ET
Table 'Atalante' 6-max Seat #2 is the button
Seat 1: iknewyouhadit ($246.93 in chips)
Seat 2: CharlieM84 ($381.20 in chips)
Seat 3: rkinney64 ($247.87 in chips)
Seat 5: jack wipe7 ($134.67 in chips)
Seat 6: ColonelPhorbin ($15.39 in chips)
rkinney64: posts small blind $1
jack wipe7: posts big blind $2
*** HOLE CARDS ***
ColonelPhorbin: folds
iknewyouhadit: folds
CharlieM84: raises $3 to $5
rkinney64: calls $4
jack wipe7: raises $21 to $26
CharlieM84: folds
rkinney64: folds
Uncalled bet ($21) returned to jack wipe7
jack wipe7 collected $15 from pot
jack wipe7: doesn't show hand
*** SUMMARY ***
Total pot $15 | Rake $0
Seat 1: iknewyouhadit folded before Flop (didn't bet)
Seat 2: CharlieM84 (button) folded before Flop
Seat 3: rkinney64 (small blind) folded before Flop
Seat 5: jack wipe7 (big blind) collected ($15)
Seat 6: ColonelPhorbin folded before Flop (didn't bet)


PokerStars Hand #232992207417:  Hold'em No Limit ($1/$2 USD) - 2022/01/16 11:59:07 ET
Table 'Atalante' 6-max Seat #3 is the button
Seat 1: iknewyouhadit ($246.93 in chips)
Seat 2: CharlieM84 ($376.20 in chips)
Seat 3: rkinney64 ($242.87 in chips)
Seat 5: jack wipe7 ($144.67 in chips)
Seat 6: ColonelPhorbin ($200 in chips)
jack wipe7: posts small blind $1
ColonelPhorbin: posts big blind $2
*** HOLE CARDS ***
iknewyouhadit: folds
CharlieM84: folds
rkinney64: raises $4 to $6
jack wipe7: calls $5
ColonelPhorbin: folds
*** FLOP *** [Jh 6h Ts]
jack wipe7: checks
rkinney64: checks
*** TURN *** [Jh 6h Ts] [6s]
jack wipe7: checks
rkinney64: checks
*** RIVER *** [Jh 6h Ts 6s] [8c]
jack wipe7: bets $6
rkinney64: folds
Uncalled bet ($6) returned to jack wipe7
jack wipe7 collected $13.30 from pot
jack wipe7: doesn't show hand
*** SUMMARY ***
Total pot $14 | Rake $0.70
Board [Jh 6h Ts 6s 8c]
Seat 1: iknewyouhadit folded before Flop (didn't bet)
Seat 2: CharlieM84 folded before Flop (didn't bet)
Seat 3: rkinney64 (button) folded on the River
Seat 5: jack wipe7 (small blind) collected ($13.30)
Seat 6: ColonelPhorbin (big blind) folded before Flop


PokerStars Hand #232992207635:  Hold'em No Limit ($1/$2 USD) - 2022/01/16 11:59:57 ET
Table 'Atalante' 6-max Seat #5 is the button
Seat 1: iknewyouhadit ($246.93 in chips)
Seat 2: CharlieM84 ($376.20 in chips)
Seat 3: rkinney64 ($236.87 in chips)
Seat 5: jack wipe7 ($151.97 in chips)
Seat 6: ColonelPhorbin ($198 in chips)
ColonelPhorbin: posts small blind $1
iknewyouhadit: posts big blind $2
*** HOLE CARDS ***
CharlieM84: raises $3 to $5
rkinney64: folds
jack wipe7: folds
ColonelPhorbin: calls $4
iknewyouhadit: folds
*** FLOP *** [Jc 3d 9d]
ColonelPhorbin: checks
CharlieM84: checks
*** TURN *** [Jc 3d 9d] [Jh]
ColonelPhorbin: bets $11.40
CharlieM84: calls $11.40
*** RIVER *** [Jc 3d 9d Jh] [4d]
ColonelPhorbin: checks
CharlieM84: checks
*** SHOW DOWN ***
ColonelPhorbin: shows [7d 7c] (two pair, Jacks and Sevens)
CharlieM84: shows [Ts Th] (two pair, Jacks and Tens)
CharlieM84 collected $33.06 from pot
*** SUMMARY ***
Total pot $34.80 | Rake $1.74
Board [Jc 3d 9d Jh 4d]
Seat 1: iknewyouhadit (big blind) folded before Flop
Seat 2: CharlieM84 showed [Ts Th] and won ($33.06) with two pair, Jacks and Tens
Seat 3: rkinney64 folded before Flop (didn't bet)
Seat 5: jack wipe7 (button) folded before Flop (didn't bet)
Seat 6: ColonelPhorbin (small blind) showed [7d 7c] and lost with two pair, Jacks and Sevens


PokerStars Hand #232992207925:  Hold'em No Limit ($1/$2 USD) - 2022/01/16 12:00:57 ET
Table 'Atalante' 6-max Seat #6 is the button
Seat 1: iknewyouhadit ($244.93 in chips)
Seat 2: CharlieM84 ($392.86 in chips)
Seat 3: rkinney64 ($236.87 in chips)
Seat 5: jack wipe7 ($151.97 in chips)
Seat 6: ColonelPhorbin ($181.60 in chips)
iknewyouhadit: posts small blind $1
CharlieM84: posts big blind $2
dnagel222: sits out
*** HOLE CARDS ***
rkinney64: raises $4 to $6
jack wipe7: folds
ColonelPhorbin: calls $6
iknewyouhadit: folds
CharlieM84: folds
*** FLOP *** [Ad Jh Ac]
rkinney64: checks
ColonelPhorbin: checks
*** TURN *** [Ad Jh Ac] [Kh]
rkinney64: checks
ColonelPhorbin: bets $14.25
rkinney64: folds
Uncalled bet ($14.25) returned to ColonelPhorbin
ColonelPhorbin collected $14.25 from pot
*** SUMMARY ***
Total pot $15 | Rake $0.75
Board [Ad Jh Ac Kh]
Seat 1: iknewyouhadit (small blind) folded before Flop
Seat 2: CharlieM84 (big blind) folded before Flop
Seat 3: rkinney64 folded on the Turn
Seat 5: jack wipe7 folded before Flop (didn't bet)
Seat 6: ColonelPhorbin (button) collected ($14.25)


PokerStars Hand #232992208080:  Hold'em No Limit ($1/$2 USD) - 2022/01/16 12:01:27 ET
Table 'Atalante' 6-max Seat #1 is the button
Seat 1: iknewyouhadit ($243.93 in chips)
Seat 2: CharlieM84 ($390.86 in chips)
Seat 3: rkinney64 ($230.87 in chips)
Seat 5: jack wipe7 ($151.97 in chips)
Seat 6: ColonelPhorbin ($189.85 in chips)
CharlieM84: posts small blind $1
rkinney64: posts big blind $2
dnagel222: sits out
*** HOLE CARDS ***
jack wipe7: folds
ColonelPhorbin: calls $2
iknewyouhadit: folds
CharlieM84: calls $1
rkinney64: checks
*** FLOP *** [8h 9d Kd]
CharlieM84: checks
rkinney64: checks
ColonelPhorbin: checks
*** TURN *** [8h 9d Kd] [5c]
CharlieM84: checks
rkinney64: checks
ColonelPhorbin: bets $5.70
CharlieM84: folds
rkinney64: raises $44.30 to $50
ColonelPhorbin: folds
Uncalled bet ($44.30) returned to rkinney64
rkinney64 collected $16.53 from pot
rkinney64: doesn't show hand
*** SUMMARY ***
Total pot $17.40 | Rake $0.87
Board [8h 9d Kd 5c]
Seat 1: iknewyouhadit (button) folded before Flop (didn't bet)
Seat 2: CharlieM84 (small blind) folded on the Turn
Seat 3: rkinney64 (big blind) collected ($16.53)
Seat 5: jack wipe7 folded before Flop (didn't bet)
Seat 6: ColonelPhorbin folded on the Turn


PokerStars Hand #232992208437:  Hold'em No Limit ($1/$2 USD) - 2022/01/16 12:02:44 ET
Table 'Atalante' 6-max Seat #2 is the button
Seat 1: iknewyouhadit ($243.93 in chips)
Seat 2: CharlieM84 ($388.86 in chips)
Seat 3: rkinney64 ($239.70 in chips)
Seat 4: dnagel222 ($82.90 in chips)
Seat 5: jack wipe7 ($151.97 in chips)
Seat 6: ColonelPhorbin ($182.15 in chips)
rkinney64: posts small blind $1
dnagel222: posts big blind $2
*** HOLE CARDS ***
jack wipe7: raises $4 to $6
ColonelPhorbin: folds
iknewyouhadit: folds
CharlieM84: folds
rkinney64: folds
dnagel222: folds
Uncalled bet ($4) returned to jack wipe7
jack wipe7 collected $5 from pot
jack wipe7: doesn't show hand
*** SUMMARY ***
Total pot $5 | Rake $0
Seat 1: iknewyouhadit folded before Flop (didn't bet)
Seat 2: CharlieM84 (button) folded before Flop (didn't bet)
Seat 3: rkinney64 (small blind) folded before Flop
Seat 4: dnagel222 (big blind) folded before Flop
Seat 5: jack wipe7 collected ($5)
Seat 6: ColonelPhorbin folded before Flop (didn't bet)


PokerStars Hand #232992208625:  Hold'em No Limit ($1/$2 USD) - 2022/01/16 12:03:20 ET
Table 'Atalante' 6-max Seat #3 is the button
Seat 1: iknewyouhadit ($243.93 in chips)
Seat 2: CharlieM84 ($388.86 in chips)
Seat 3: rkinney64 ($238.70 in chips)
Seat 4: dnagel222 ($80.90 in chips)
Seat 6: ColonelPhorbin ($182.15 in chips)
dnagel222: posts small blind $1
jack wipe7: is sitting out
ColonelPhorbin: posts big blind $2
*** HOLE CARDS ***
iknewyouhadit: folds
CharlieM84: raises $3 to $5
rkinney64: folds
jack wipe7 leaves the table
dnagel222: folds
ColonelPhorbin: calls $3
*** FLOP *** [4c Jc 8d]
ColonelPhorbin: bets $10.45
CharlieM84: folds
Uncalled bet ($10.45) returned to ColonelPhorbin
ColonelPhorbin collected $10.45 from pot
*** SUMMARY ***
Total pot $11 | Rake $0.55
Board [4c Jc 8d]
Seat 1: iknewyouhadit folded before Flop (didn't bet)
Seat 2: CharlieM84 folded on the Flop
Seat 3: rkinney64 (button) folded before Flop (didn't bet)
Seat 4: dnagel222 (small blind) folded before Flop
Seat 6: ColonelPhorbin (big blind) collected ($10.45)


PokerStars Hand #232992208726:  Hold'em No Limit ($1/$2 USD) - 2022/01/16 12:03:40 ET
Table 'Atalante' 6-max Seat #4 is the button
Seat 1: iknewyouhadit ($243.93 in chips)
Seat 2: CharlieM84 ($383.86 in chips)
Seat 3: rkinney64 ($238.70 in chips)
Seat 4: dnagel222 ($79.90 in chips)
Seat 6: ColonelPhorbin ($187.60 in chips)
ColonelPhorbin: posts small blind $1
iknewyouhadit: posts big blind $2
*** HOLE CARDS ***
CharlieM84: folds
rkinney64: folds
dnagel222: calls $2
ColonelPhorbin: calls $1
iknewyouhadit: checks
*** FLOP *** [Qc 4c Ah]
ColonelPhorbin: checks
iknewyouhadit: checks
dnagel222: bets $2
ColonelPhorbin: folds
iknewyouhadit: folds
Uncalled bet ($2) returned to dnagel222
dnagel222 collected $5.70 from pot
*** SUMMARY ***
Total pot $6 | Rake $0.30
Board [Qc 4c Ah]
Seat 1: iknewyouhadit (big blind) folded on the Flop
Seat 2: CharlieM84 folded before Flop (didn't bet)
Seat 3: rkinney64 folded before Flop (didn't bet)
Seat 4: dnagel222 (button) collected ($5.70)
Seat 6: ColonelPhorbin (small blind) folded on the Flop


PokerStars Hand #232992208859:  Hold'em No Limit ($1/$2 USD) - 2022/01/16 12:04:10 ET
Table 'Atalante' 6-max Seat #6 is the button
Seat 1: iknewyouhadit ($241.93 in chips)
Seat 2: CharlieM84 ($383.86 in chips)
Seat 3: rkinney64 ($238.70 in chips)
Seat 4: dnagel222 ($83.60 in chips)
Seat 6: ColonelPhorbin ($185.60 in chips)
iknewyouhadit: posts small blind $1
CharlieM84: posts big blind $2
*** HOLE CARDS ***
rkinney64: folds
dnagel222: calls $2
ColonelPhorbin: raises $2 to $4
iknewyouhadit: folds
CharlieM84: folds
dnagel222: calls $2
*** FLOP *** [Kd Tc 2s]
dnagel222: checks
ColonelPhorbin: checks
*** TURN *** [Kd Tc 2s] [2h]
dnagel222: checks
ColonelPhorbin: bets $10.45
dnagel222: folds
Uncalled bet ($10.45) returned to ColonelPhorbin
ColonelPhorbin collected $10.45 from pot
*** SUMMARY ***
Total pot $11 | Rake $0.55
Board [Kd Tc 2s 2h]
Seat 1: iknewyouhadit (small blind) folded before Flop
Seat 2: CharlieM84 (big blind) folded before Flop
Seat 3: rkinney64 folded before Flop (didn't bet)
Seat 4: dnagel222 folded on the Turn
Seat 6: ColonelPhorbin (button) collected ($10.45)


PokerStars Hand #232992209123:  Hold'em No Limit ($1/$2 USD) - 2022/01/16 12:05:03 ET
Table 'Atalante' 6-max Seat #1 is the button
Seat 1: iknewyouhadit ($240.93 in chips)
Seat 2: CharlieM84 ($381.86 in chips)
Seat 3: rkinney64 ($238.70 in chips)
Seat 4: dnagel222 ($79.60 in chips)
Seat 6: ColonelPhorbin ($192.05 in chips)
CharlieM84: posts small blind $1
rkinney64: posts big blind $2
*** HOLE CARDS ***
dnagel222: folds
ColonelPhorbin: raises $2 to $4
iknewyouhadit: folds
CharlieM84: folds
rkinney64: calls $2
*** FLOP *** [6c 2s 8d]
rkinney64: checks
ColonelPhorbin: checks
*** TURN *** [6c 2s 8d] [Jc]
rkinney64: checks
ColonelPhorbin: bets $8.55
rkinney64: calls $8.55
*** RIVER *** [6c 2s 8d Jc] [4d]
rkinney64: checks
ColonelPhorbin: bets $24.80
rkinney64: calls $24.80
*** SHOW DOWN ***
ColonelPhorbin: shows [Ah 9h] (high card Ace)
rkinney64: shows [Jd Ad] (a pair of Jacks)
rkinney64 collected $72.70 from pot
*** SUMMARY ***
Total pot $75.70 | Rake $3
Board [6c 2s 8d Jc 4d]
Seat 1: iknewyouhadit (button) folded before Flop (didn't bet)
Seat 2: CharlieM84 (small blind) folded before Flop
Seat 3: rkinney64 (big blind) showed [Jd Ad] and won ($72.70) with a pair of Jacks
Seat 4: dnagel222 folded before Flop (didn't bet)
Seat 6: ColonelPhorbin showed [Ah 9h] and lost with high card Ace


PokerStars Hand #232992209275:  Hold'em No Limit ($1/$2 USD) - 2022/01/16 12:05:37 ET
Table 'Atalante' 6-max Seat #2 is the button
Seat 1: iknewyouhadit ($240.93 in chips)
Seat 2: CharlieM84 ($380.86 in chips)
Seat 3: rkinney64 ($274.05 in chips)
Seat 4: dnagel222 ($79.60 in chips)
Seat 6: ColonelPhorbin ($154.70 in chips)
rkinney64: posts small blind $1
dnagel222: posts big blind $2
*** HOLE CARDS ***
ColonelPhorbin: raises $4 to $6
iknewyouhadit: folds
CharlieM84: folds
rkinney64: calls $5
dnagel222: folds
*** FLOP *** [2s 8d Ts]
rkinney64: checks
mrdust1 joins the table at seat #5
ColonelPhorbin: bets $13.30
rkinney64: folds
Uncalled bet ($13.30) returned to ColonelPhorbin
ColonelPhorbin collected $13.30 from pot
*** SUMMARY ***
Total pot $14 | Rake $0.70
Board [2s 8d Ts]
Seat 1: iknewyouhadit folded before Flop (didn't bet)
Seat 2: CharlieM84 (button) folded before Flop (didn't bet)
Seat 3: rkinney64 (small blind) folded on the Flop
Seat 4: dnagel222 (big blind) folded before Flop
Seat 6: ColonelPhorbin collected ($13.30)


PokerStars Hand #232992209479:  Hold'em No Limit ($1/$2 USD) - 2022/01/16 12:06:17 ET
Table 'Atalante' 6-max Seat #3 is the button
Seat 1: iknewyouhadit ($240.93 in chips)
Seat 2: CharlieM84 ($380.86 in chips)
Seat 3: rkinney64 ($268.05 in chips)
Seat 4: dnagel222 ($77.60 in chips)
Seat 5: mrdust1 ($200 in chips)
Seat 6: ColonelPhorbin ($162 in chips)
dnagel222: posts small blind $1
mrdust1: posts big blind $2
*** HOLE CARDS ***
ColonelPhorbin: raises $2 to $4
iknewyouhadit: raises $11 to $15
CharlieM84: folds
rkinney64: folds
dnagel222: folds
mrdust1: folds
ColonelPhorbin: calls $11
*** FLOP *** [8s Th 3d]
ColonelPhorbin: checks
iknewyouhadit: checks
*** TURN *** [8s Th 3d] [7c]
ColonelPhorbin: checks
iknewyouhadit: checks
*** RIVER *** [8s Th 3d 7c] [4d]
ColonelPhorbin: bets $31.35
iknewyouhadit: folds
Uncalled bet ($31.35) returned to ColonelPhorbin
ColonelPhorbin collected $31.35 from pot
*** SUMMARY ***
Total pot $33 | Rake $1.65
Board [8s Th 3d 7c 4d]
Seat 1: iknewyouhadit folded on the River
Seat 2: CharlieM84 folded before Flop (didn't bet)
Seat 3: rkinney64 (button) folded before Flop (didn't bet)
Seat 4: dnagel222 (small blind) folded before Flop
Seat 5: mrdust1 (big blind) folded before Flop
Seat 6: ColonelPhorbin collected ($31.35)


PokerStars Hand #232992209795:  Hold'em No Limit ($1/$2 USD) - 2022/01/16 12:07:19 ET
Table 'Atalante' 6-max Seat #4 is the button
Seat 1: iknewyouhadit ($225.93 in chips)
Seat 2: CharlieM84 ($380.86 in chips)
Seat 3: rkinney64 ($268.05 in chips)
Seat 4: dnagel222 ($76.60 in chips)
Seat 5: mrdust1 ($200 in chips)
Seat 6: ColonelPhorbin ($178.35 in chips)
mrdust1: posts small blind $1
ColonelPhorbin: posts big blind $2
*** HOLE CARDS ***
iknewyouhadit: folds
CharlieM84: raises $3 to $5
rkinney64: folds
dnagel222: folds
mrdust1: folds
ColonelPhorbin: folds
Uncalled bet ($3) returned to CharlieM84
CharlieM84 collected $5 from pot
CharlieM84: doesn't show hand
*** SUMMARY ***
Total pot $5 | Rake $0
Seat 1: iknewyouhadit folded before Flop (didn't bet)
Seat 2: CharlieM84 collected ($5)
Seat 3: rkinney64 folded before Flop (didn't bet)
Seat 4: dnagel222 (button) folded before Flop (didn't bet)
Seat 5: mrdust1 (small blind) folded before Flop
Seat 6: ColonelPhorbin (big blind) folded before Flop


PokerStars Hand #232992209862:  Hold'em No Limit ($1/$2 USD) - 2022/01/16 12:07:32 ET
Table 'Atalante' 6-max Seat #5 is the button
Seat 1: iknewyouhadit ($225.93 in chips)
Seat 2: CharlieM84 ($383.86 in chips)
Seat 3: rkinney64 ($268.05 in chips)
Seat 4: dnagel222 ($76.60 in chips)
Seat 5: mrdust1 ($200 in chips)
Seat 6: ColonelPhorbin ($176.35 in chips)
ColonelPhorbin: posts small blind $1
iknewyouhadit: posts big blind $2
*** HOLE CARDS ***
CharlieM84: folds
rkinney64: folds
dnagel222: folds
mrdust1: raises $3 to $5
ColonelPhorbin: calls $4
iknewyouhadit: calls $3
*** FLOP *** [2s Qh Js]
ColonelPhorbin: checks
iknewyouhadit: checks
mrdust1: checks
*** TURN *** [2s Qh Js] [9c]
ColonelPhorbin: bets $14.25
iknewyouhadit: folds
mrdust1: calls $14.25
*** RIVER *** [2s Qh Js 9c] [3d]
ColonelPhorbin: checks
mrdust1: checks
*** SHOW DOWN ***
ColonelPhorbin: shows [Ad Jd] (a pair of Jacks)
mrdust1: shows [As Jc] (a pair of Jacks)
ColonelPhorbin collected $20.66 from pot
mrdust1 collected $20.66 from pot
*** SUMMARY ***
Total pot $43.50 | Rake $2.18
Board [2s Qh Js 9c 3d]
Seat 1: iknewyouhadit (big blind) folded on the Turn
Seat 2: CharlieM84 folded before Flop (didn't bet)
Seat 3: rkinney64 folded before Flop (didn't bet)
Seat 4: dnagel222 folded before Flop (didn't bet)
Seat 5: mrdust1 (button) showed [As Jc] and won ($20.66) with a pair of Jacks
Seat 6: ColonelPhorbin (small blind) showed [Ad Jd] and won ($20.66) with a pair of Jacks


PokerStars Hand #232992390246:  Hold'em No Limit ($1/$2 USD) - 2022/01/16 12:08:28 ET
Table 'Atalante' 6-max Seat #6 is the button
Seat 1: iknewyouhadit ($220.93 in chips)
Seat 2: CharlieM84 ($383.86 in chips)
Seat 3: rkinney64 ($268.05 in chips)
Seat 4: dnagel222 ($76.60 in chips)
Seat 5: mrdust1 ($201.41 in chips)
Seat 6: ColonelPhorbin ($177.76 in chips)
iknewyouhadit: posts small blind $1
CharlieM84: posts big blind $2
*** HOLE CARDS ***
rkinney64: folds
dnagel222: folds
mrdust1: folds
ColonelPhorbin: raises $2 to $4
iknewyouhadit: folds
CharlieM84: folds
Uncalled bet ($2) returned to ColonelPhorbin
ColonelPhorbin collected $5 from pot
*** SUMMARY ***
Total pot $5 | Rake $0
Seat 1: iknewyouhadit (small blind) folded before Flop
Seat 2: CharlieM84 (big blind) folded before Flop
Seat 3: rkinney64 folded before Flop (didn't bet)
Seat 4: dnagel222 folded before Flop (didn't bet)
Seat 5: mrdust1 folded before Flop (didn't bet)
Seat 6: ColonelPhorbin (button) collected ($5)


PokerStars Hand #232992390340:  Hold'em No Limit ($1/$2 USD) - 2022/01/16 12:08:46 ET
Table 'Atalante' 6-max Seat #1 is the button
Seat 1: iknewyouhadit ($219.93 in chips)
Seat 2: CharlieM84 ($381.86 in chips)
Seat 3: rkinney64 ($268.05 in chips)
Seat 4: dnagel222 ($76.60 in chips)
Seat 5: mrdust1 ($201.41 in chips)
Seat 6: ColonelPhorbin ($180.76 in chips)
CharlieM84: posts small blind $1
rkinney64: posts big blind $2
*** HOLE CARDS ***
dnagel222: folds
mrdust1: folds
ColonelPhorbin: folds
iknewyouhadit: raises $2.60 to $4.60
CharlieM84: folds
rkinney64: calls $2.60
*** FLOP *** [4d Jh Ad]
rkinney64: checks
iknewyouhadit: bets $4.85
rkinney64: folds
Uncalled bet ($4.85) returned to iknewyouhadit
iknewyouhadit collected $9.69 from pot
*** SUMMARY ***
Total pot $10.20 | Rake $0.51
Board [4d Jh Ad]
Seat 1: iknewyouhadit (button) collected ($9.69)
Seat 2: CharlieM84 (small blind) folded before Flop
Seat 3: rkinney64 (big blind) folded on the Flop
Seat 4: dnagel222 folded before Flop (didn't bet)
Seat 5: mrdust1 folded before Flop (didn't bet)
Seat 6: ColonelPhorbin folded before Flop (didn't bet)


PokerStars Hand #232992390628:  Hold'em No Limit ($1/$2 USD) - 2022/01/16 12:09:39 ET
Table 'Atalante' 6-max Seat #2 is the button
Seat 1: iknewyouhadit ($225.02 in chips)
Seat 2: CharlieM84 ($380.86 in chips)
Seat 3: rkinney64 ($263.45 in chips)
Seat 4: dnagel222 ($76.60 in chips)
Seat 5: mrdust1 ($201.41 in chips)
Seat 6: ColonelPhorbin ($180.76 in chips)
rkinney64: posts small blind $1
dnagel222: posts big blind $2
*** HOLE CARDS ***
mrdust1: folds
ColonelPhorbin: calls $2
iknewyouhadit: folds
CharlieM84: folds
rkinney64: raises $6 to $8
dnagel222: folds
ColonelPhorbin: calls $6
*** FLOP *** [2h 3s Kc]
rkinney64: bets $10
ColonelPhorbin: folds
Uncalled bet ($10) returned to rkinney64
rkinney64 collected $17.10 from pot
rkinney64: doesn't show hand
*** SUMMARY ***
Total pot $18 | Rake $0.90
Board [2h 3s Kc]
Seat 1: iknewyouhadit folded before Flop (didn't bet)
Seat 2: CharlieM84 (button) folded before Flop (didn't bet)
Seat 3: rkinney64 (small blind) collected ($17.10)
Seat 4: dnagel222 (big blind) folded before Flop
Seat 5: mrdust1 folded before Flop (didn't bet)
Seat 6: ColonelPhorbin folded on the Flop


PokerStars Hand #232992390801:  Hold'em No Limit ($1/$2 USD) - 2022/01/16 12:10:11 ET
Table 'Atalante' 6-max Seat #3 is the button
Seat 1: iknewyouhadit ($225.02 in chips)
Seat 2: CharlieM84 ($380.86 in chips)
Seat 3: rkinney64 ($272.55 in chips)
Seat 4: dnagel222 ($74.60 in chips)
Seat 5: mrdust1 ($201.41 in chips)
Seat 6: ColonelPhorbin ($172.76 in chips)
dnagel222: posts small blind $1
mrdust1: posts big blind $2
*** HOLE CARDS ***
ColonelPhorbin: folds
iknewyouhadit: folds
CharlieM84: raises $3 to $5
rkinney64: calls $5
dnagel222: folds
mrdust1: folds
*** FLOP *** [Jd Jc 7s]
CharlieM84: bets $4.08
rkinney64: calls $4.08
*** TURN *** [Jd Jc 7s] [7c]
CharlieM84: checks
rkinney64: checks
*** RIVER *** [Jd Jc 7s 7c] [6c]
CharlieM84: checks
rkinney64: checks
*** SHOW DOWN ***
CharlieM84: shows [Kd Ts] (two pair, Jacks and Sevens)
rkinney64: mucks hand
CharlieM84 collected $20.10 from pot
*** SUMMARY ***
Total pot $21.16 | Rake $1.06
Board [Jd Jc 7s 7c 6c]
Seat 1: iknewyouhadit folded before Flop (didn't bet)
Seat 2: CharlieM84 showed [Kd Ts] and won ($20.10) with two pair, Jacks and Sevens
Seat 3: rkinney64 (button) mucked
Seat 4: dnagel222 (small blind) folded before Flop
Seat 5: mrdust1 (big blind) folded before Flop
Seat 6: ColonelPhorbin folded before Flop (didn't bet)


PokerStars Hand #232992391047:  Hold'em No Limit ($1/$2 USD) - 2022/01/16 12:11:01 ET
Table 'Atalante' 6-max Seat #4 is the button
Seat 1: iknewyouhadit ($225.02 in chips)
Seat 2: CharlieM84 ($391.88 in chips)
Seat 3: rkinney64 ($263.47 in chips)
Seat 4: dnagel222 ($73.60 in chips)
Seat 5: mrdust1 ($200 in chips)
Seat 6: ColonelPhorbin ($172.76 in chips)
mrdust1: posts small blind $1
ColonelPhorbin: posts big blind $2
*** HOLE CARDS ***
iknewyouhadit: folds
CharlieM84: folds
rkinney64: folds
dnagel222: calls $2
mrdust1: raises $4.60 to $6.60
ColonelPhorbin: calls $4.60
dnagel222: calls $4.60
*** FLOP *** [Ks Js Qh]
mrdust1: bets $8.28
ColonelPhorbin: calls $8.28
dnagel222: folds
*** TURN *** [Ks Js Qh] [Ts]
mrdust1: checks
ColonelPhorbin: bets $34.54
mrdust1: calls $34.54
*** RIVER *** [Ks Js Qh Ts] [7c]
mrdust1: checks
ColonelPhorbin: checks
*** SHOW DOWN ***
mrdust1: shows [Qd Qs] (three of a kind, Queens)
ColonelPhorbin: shows [Th 9d] (a straight, Nine to King)
ColonelPhorbin collected $102.44 from pot
*** SUMMARY ***
Total pot $105.44 | Rake $3
Board [Ks Js Qh Ts 7c]
Seat 1: iknewyouhadit folded before Flop (didn't bet)
Seat 2: CharlieM84 folded before Flop (didn't bet)
Seat 3: rkinney64 folded before Flop (didn't bet)
Seat 4: dnagel222 (button) folded on the Flop
Seat 5: mrdust1 (small blind) showed [Qd Qs] and lost with three of a kind, Queens
Seat 6: ColonelPhorbin (big blind) showed [Th 9d] and won ($102.44) with a straight, Nine to King


PokerStars Hand #232992391569:  Hold'em No Limit ($1/$2 USD) - 2022/01/16 12:12:42 ET
Table 'Atalante' 6-max Seat #5 is the button
Seat 1: iknewyouhadit ($225.02 in chips)
Seat 2: CharlieM84 ($391.88 in chips)
Seat 3: rkinney64 ($263.47 in chips)
Seat 4: dnagel222 ($67 in chips)
Seat 5: mrdust1 ($200 in chips)
Seat 6: ColonelPhorbin ($225.78 in chips)
ColonelPhorbin: posts small blind $1
iknewyouhadit: posts big blind $2
*** HOLE CARDS ***
CharlieM84: folds
rkinney64: folds
dnagel222: folds
mrdust1: raises $3 to $5
ColonelPhorbin: raises $3 to $8
iknewyouhadit: folds
mrdust1: raises $16 to $24
ColonelPhorbin: calls $16
*** FLOP *** [4c 9h 2s]
ColonelPhorbin: checks
mrdust1: checks
*** TURN *** [4c 9h 2s] [Ac]
ColonelPhorbin: bets $47.50
mrdust1: calls $47.50
*** RIVER *** [4c 9h 2s Ac] [Kc]
ColonelPhorbin: bets $154.28 and is all-in
mrdust1: calls $128.50 and is all-in
Uncalled bet ($25.78) returned to ColonelPhorbin
*** SHOW DOWN ***
ColonelPhorbin: shows [Ks Ah] (two pair, Aces and Kings)
mrdust1: shows [Kd Ad] (two pair, Aces and Kings)
ColonelPhorbin collected $199.50 from pot
mrdust1 collected $199.50 from pot
*** SUMMARY ***
Total pot $402 | Rake $3
Board [4c 9h 2s Ac Kc]
Seat 1: iknewyouhadit (big blind) folded before Flop
Seat 2: CharlieM84 folded before Flop (didn't bet)
Seat 3: rkinney64 folded before Flop (didn't bet)
Seat 4: dnagel222 folded before Flop (didn't bet)
Seat 5: mrdust1 (button) showed [Kd Ad] and won ($199.50) with two pair, Aces and Kings
Seat 6: ColonelPhorbin (small blind) showed [Ks Ah] and won ($199.50) with two pair, Aces and Kings


PokerStars Hand #232992391956:  Hold'em No Limit ($1/$2 USD) - 2022/01/16 12:13:58 ET
Table 'Atalante' 6-max Seat #6 is the button
Seat 1: iknewyouhadit ($223.02 in chips)
Seat 2: CharlieM84 ($391.88 in chips)
Seat 3: rkinney64 ($263.47 in chips)
Seat 4: dnagel222 ($67 in chips)
Seat 5: mrdust1 ($200 in chips)
Seat 6: ColonelPhorbin ($225.28 in chips)
iknewyouhadit: posts small blind $1
CharlieM84: posts big blind $2
*** HOLE CARDS ***
rkinney64: folds
dnagel222: raises $5 to $7
mrdust1: folds
ColonelPhorbin: calls $7
iknewyouhadit: folds
CharlieM84: calls $5
*** FLOP *** [Kc 5h Jc]
CharlieM84: checks
dnagel222: checks
ColonelPhorbin: checks
*** TURN *** [Kc 5h Jc] [3c]
CharlieM84: checks
dnagel222: bets $2
ColonelPhorbin: calls $2
CharlieM84: calls $2
*** RIVER *** [Kc 5h Jc 3c] [3h]
CharlieM84: checks
dnagel222: bets $2
ColonelPhorbin: raises $30.60 to $32.60
CharlieM84: folds
dnagel222: folds
Uncalled bet ($30.60) returned to ColonelPhorbin
ColonelPhorbin collected $30.40 from pot
*** SUMMARY ***
Total pot $32 | Rake $1.60
Board [Kc 5h Jc 3c 3h]
Seat 1: iknewyouhadit (small blind) folded before Flop
Seat 2: CharlieM84 (big blind) folded on the River
Seat 3: rkinney64 folded before Flop (didn't bet)
Seat 4: dnagel222 folded on the River
Seat 5: mrdust1 folded before Flop (didn't bet)
Seat 6: ColonelPhorbin (button) collected ($30.40)


PokerStars Hand #232992392367:  Hold'em No Limit ($1/$2 USD) - 2022/01/16 12:15:17 ET
Table 'Atalante' 6-max Seat #1 is the button
Seat 1: iknewyouhadit ($222.02 in chips)
Seat 2: CharlieM84 ($382.88 in chips)
Seat 3: rkinney64 ($263.47 in chips)
Seat 4: dnagel222 ($56 in chips)
Seat 5: mrdust1 ($200 in chips)
Seat 6: ColonelPhorbin ($244.68 in chips)
CharlieM84: posts small blind $1
rkinney64: posts big blind $2
*** HOLE CARDS ***
dnagel222: folds
mrdust1: raises $3 to $5
ColonelPhorbin: folds
iknewyouhadit: folds
CharlieM84: folds
rkinney64: calls $3
*** FLOP *** [Ac 5d Qh]
rkinney64: checks
mrdust1: bets $3.45
rkinney64: folds
Uncalled bet ($3.45) returned to mrdust1
mrdust1 collected $10.45 from pot
mrdust1: doesn't show hand
*** SUMMARY ***
Total pot $11 | Rake $0.55
Board [Ac 5d Qh]
Seat 1: iknewyouhadit (button) folded before Flop (didn't bet)
Seat 2: CharlieM84 (small blind) folded before Flop
Seat 3: rkinney64 (big blind) folded on the Flop
Seat 4: dnagel222 folded before Flop (didn't bet)
Seat 5: mrdust1 collected ($10.45)
Seat 6: ColonelPhorbin folded before Flop (didn't bet)


PokerStars Hand #232992392544:  Hold'em No Limit ($1/$2 USD) - 2022/01/16 12:15:52 ET
Table 'Atalante' 6-max Seat #2 is the button
Seat 1: iknewyouhadit ($222.02 in chips)
Seat 2: CharlieM84 ($381.88 in chips)
Seat 3: rkinney64 ($258.47 in chips)
Seat 4: dnagel222 ($56 in chips)
Seat 5: mrdust1 ($205.45 in chips)
Seat 6: ColonelPhorbin ($244.68 in chips)
rkinney64: posts small blind $1
dnagel222: posts big blind $2
*** HOLE CARDS ***
mrdust1: folds
ColonelPhorbin: folds
iknewyouhadit: folds
CharlieM84: raises $3 to $5
rkinney64: folds
dnagel222: folds
Uncalled bet ($3) returned to CharlieM84
CharlieM84 collected $5 from pot
CharlieM84: doesn't show hand
*** SUMMARY ***
Total pot $5 | Rake $0
Seat 1: iknewyouhadit folded before Flop (didn't bet)
Seat 2: CharlieM84 (button) collected ($5)
Seat 3: rkinney64 (small blind) folded before Flop
Seat 4: dnagel222 (big blind) folded before Flop
Seat 5: mrdust1 folded before Flop (didn't bet)
Seat 6: ColonelPhorbin folded before Flop (didn't bet)


PokerStars Hand #232992392747:  Hold'em No Limit ($1/$2 USD) - 2022/01/16 12:16:32 ET
Table 'Atalante' 6-max Seat #3 is the button
Seat 1: iknewyouhadit ($222.02 in chips)
Seat 2: CharlieM84 ($384.88 in chips)
Seat 3: rkinney64 ($257.47 in chips)
Seat 4: dnagel222 ($54 in chips)
Seat 5: mrdust1 ($205.45 in chips)
Seat 6: ColonelPhorbin ($244.68 in chips)
dnagel222: posts small blind $1
mrdust1: posts big blind $2
*** HOLE CARDS ***
ColonelPhorbin: folds
iknewyouhadit: raises $2.60 to $4.60
CharlieM84: raises $10.40 to $15
rkinney64: calls $15
dnagel222: folds
mrdust1: folds
iknewyouhadit: calls $10.40
*** FLOP *** [2d 2h 8c]
iknewyouhadit: checks
CharlieM84: checks
rkinney64: checks
*** TURN *** [2d 2h 8c] [7h]
iknewyouhadit: checks
CharlieM84: checks
rkinney64: checks
*** RIVER *** [2d 2h 8c 7h] [9s]
iknewyouhadit: bets $34.66
CharlieM84: folds
rkinney64: folds
Uncalled bet ($34.66) returned to iknewyouhadit
iknewyouhadit collected $45.60 from pot
*** SUMMARY ***
Total pot $48 | Rake $2.40
Board [2d 2h 8c 7h 9s]
Seat 1: iknewyouhadit collected ($45.60)
Seat 2: CharlieM84 folded on the River
Seat 3: rkinney64 (button) folded on the River
Seat 4: dnagel222 (small blind) folded before Flop
Seat 5: mrdust1 (big blind) folded before Flop
Seat 6: ColonelPhorbin folded before Flop (didn't bet)


PokerStars Hand #232992393153:  Hold'em No Limit ($1/$2 USD) - 2022/01/16 12:17:49 ET
Table 'Atalante' 6-max Seat #4 is the button
Seat 1: iknewyouhadit ($252.62 in chips)
Seat 2: CharlieM84 ($369.88 in chips)
Seat 3: rkinney64 ($242.47 in chips)
Seat 4: dnagel222 ($53 in chips)
Seat 5: mrdust1 ($203.45 in chips)
Seat 6: ColonelPhorbin ($244.68 in chips)
mrdust1: posts small blind $1
ColonelPhorbin: posts big blind $2
*** HOLE CARDS ***
iknewyouhadit: folds
CharlieM84: raises $3 to $5
rkinney64: folds
dnagel222: folds
mrdust1: folds
ColonelPhorbin: calls $3
*** FLOP *** [Qh 6s 4d]
ColonelPhorbin: checks
CharlieM84: bets $5.23
ColonelPhorbin: folds
Uncalled bet ($5.23) returned to CharlieM84
CharlieM84 collected $10.45 from pot
CharlieM84: doesn't show hand
*** SUMMARY ***
Total pot $11 | Rake $0.55
Board [Qh 6s 4d]
Seat 1: iknewyouhadit folded before Flop (didn't bet)
Seat 2: CharlieM84 collected ($10.45)
Seat 3: rkinney64 folded before Flop (didn't bet)
Seat 4: dnagel222 (button) folded before Flop (didn't bet)
Seat 5: mrdust1 (small blind) folded before Flop
Seat 6: ColonelPhorbin (big blind) folded on the Flop


PokerStars Hand #232992393326:  Hold'em No Limit ($1/$2 USD) - 2022/01/16 12:18:25 ET
Table 'Atalante' 6-max Seat #5 is the button
Seat 1: iknewyouhadit ($252.62 in chips)
Seat 2: CharlieM84 ($375.33 in chips)
Seat 3: rkinney64 ($242.47 in chips)
Seat 4: dnagel222 ($53 in chips)
Seat 5: mrdust1 ($202.45 in chips)
Seat 6: ColonelPhorbin ($239.68 in chips)
ColonelPhorbin: posts small blind $1
iknewyouhadit: posts big blind $2
*** HOLE CARDS ***
CharlieM84: folds
rkinney64: folds
dnagel222: folds
mrdust1: raises $3 to $5
ColonelPhorbin: calls $4
iknewyouhadit: folds
*** FLOP *** [9c Qc Td]
ColonelPhorbin: checks
mrdust1: checks
*** TURN *** [9c Qc Td] [As]
ColonelPhorbin: bets $11.40
mrdust1: calls $11.40
*** RIVER *** [9c Qc Td As] [9s]
ColonelPhorbin: bets $16.53
mrdust1: calls $16.53
*** SHOW DOWN ***
ColonelPhorbin: shows [Th Kh] (two pair, Tens and Nines)
mrdust1: shows [Ad 2d] (two pair, Aces and Nines)
mrdust1 collected $64.86 from pot
*** SUMMARY ***
Total pot $67.86 | Rake $3
Board [9c Qc Td As 9s]
Seat 1: iknewyouhadit (big blind) folded before Flop
Seat 2: CharlieM84 folded before Flop (didn't bet)
Seat 3: rkinney64 folded before Flop (didn't bet)
Seat 4: dnagel222 folded before Flop (didn't bet)
Seat 5: mrdust1 (button) showed [Ad 2d] and won ($64.86) with two pair, Aces and Nines
Seat 6: ColonelPhorbin (small blind) showed [Th Kh] and lost with two pair, Tens and Nines


PokerStars Hand #232992393744:  Hold'em No Limit ($1/$2 USD) - 2022/01/16 12:19:43 ET
Table 'Atalante' 6-max Seat #6 is the button
Seat 1: iknewyouhadit ($250.62 in chips)
Seat 2: CharlieM84 ($375.33 in chips)
Seat 3: rkinney64 ($242.47 in chips)
Seat 4: dnagel222 ($53 in chips)
Seat 5: mrdust1 ($234.38 in chips)
Seat 6: ColonelPhorbin ($206.75 in chips)
iknewyouhadit: posts small blind $1
CharlieM84: posts big blind $2
*** HOLE CARDS ***
rkinney64: folds
dnagel222: calls $2
mrdust1: raises $4.60 to $6.60
ColonelPhorbin: calls $6.60
iknewyouhadit: folds
CharlieM84: folds
dnagel222: calls $4.60
*** FLOP *** [3d Qh Kh]
dnagel222: checks
mrdust1: bets $7.15
ColonelPhorbin: folds
dnagel222: calls $7.15
*** TURN *** [3d Qh Kh] [6d]
dnagel222: checks
mrdust1: bets $220.63 and is all-in
dnagel222: calls $39.25 and is all-in
Uncalled bet ($181.38) returned to mrdust1
*** RIVER *** [3d Qh Kh 6d] [3h]
*** SHOW DOWN ***
dnagel222: shows [Jh 7h] (a flush, King high)
mrdust1: shows [Kc Ad] (two pair, Kings and Threes)
dnagel222 collected $112.60 from pot
*** SUMMARY ***
Total pot $115.60 | Rake $3
Board [3d Qh Kh 6d 3h]
Seat 1: iknewyouhadit (small blind) folded before Flop
Seat 2: CharlieM84 (big blind) folded before Flop
Seat 3: rkinney64 folded before Flop (didn't bet)
Seat 4: dnagel222 showed [Jh 7h] and won ($112.60) with a flush, King high
Seat 5: mrdust1 showed [Kc Ad] and lost with two pair, Kings and Threes
Seat 6: ColonelPhorbin (button) folded on the Flop


PokerStars Hand #232992394116:  Hold'em No Limit ($1/$2 USD) - 2022/01/16 12:20:53 ET
Table 'Atalante' 6-max Seat #1 is the button
Seat 1: iknewyouhadit ($249.62 in chips)
Seat 2: CharlieM84 ($373.33 in chips)
Seat 3: rkinney64 ($242.47 in chips)
Seat 4: dnagel222 ($112.60 in chips)
Seat 5: mrdust1 ($200 in chips)
Seat 6: ColonelPhorbin ($200.15 in chips)
CharlieM84: posts small blind $1
rkinney64: posts big blind $2
*** HOLE CARDS ***
dnagel222: calls $2
mrdust1: folds
ColonelPhorbin: calls $2
iknewyouhadit: folds
CharlieM84: calls $1
rkinney64: checks
*** FLOP *** [2c 6s 2d]
CharlieM84: checks
rkinney64: checks
dnagel222: checks
ColonelPhorbin: checks
*** TURN *** [2c 6s 2d] [6h]
CharlieM84: checks
rkinney64: checks
dnagel222: checks
ColonelPhorbin: checks
*** RIVER *** [2c 6s 2d 6h] [Tc]
CharlieM84: checks
rkinney64: checks
dnagel222: bets $2
ColonelPhorbin: calls $2
CharlieM84: folds
rkinney64: folds
*** SHOW DOWN ***
dnagel222: shows [9h Th] (two pair, Tens and Sixes)
ColonelPhorbin: mucks hand
dnagel222 collected $11.40 from pot
*** SUMMARY ***
Total pot $12 | Rake $0.60
Board [2c 6s 2d 6h Tc]
Seat 1: iknewyouhadit (button) folded before Flop (didn't bet)
Seat 2: CharlieM84 (small blind) folded on the River
Seat 3: rkinney64 (big blind) folded on the River
Seat 4: dnagel222 showed [9h Th] and won ($11.40) with two pair, Tens and Sixes
Seat 5: mrdust1 folded before Flop (didn't bet)
Seat 6: ColonelPhorbin mucked


PokerStars Hand #232992394587:  Hold'em No Limit ($1/$2 USD) - 2022/01/16 12:22:20 ET
Table 'Atalante' 6-max Seat #2 is the button
Seat 1: iknewyouhadit ($249.62 in chips)
Seat 2: CharlieM84 ($371.33 in chips)
Seat 3: rkinney64 ($240.47 in chips)
Seat 4: dnagel222 ($120 in chips)
Seat 5: mrdust1 ($200 in chips)
Seat 6: ColonelPhorbin ($196.15 in chips)
rkinney64: posts small blind $1
dnagel222: posts big blind $2
*** HOLE CARDS ***
mrdust1: folds
ColonelPhorbin: calls $2
iknewyouhadit: folds
CharlieM84: folds
rkinney64: calls $1
dnagel222: checks
*** FLOP *** [Td 8s 2s]
rkinney64: bets $6
dnagel222: folds
ColonelPhorbin: folds
Uncalled bet ($6) returned to rkinney64
rkinney64 collected $5.70 from pot
rkinney64: doesn't show hand
*** SUMMARY ***
Total pot $6 | Rake $0.30
Board [Td 8s 2s]
Seat 1: iknewyouhadit folded before Flop (didn't bet)
Seat 2: CharlieM84 (button) folded before Flop (didn't bet)
Seat 3: rkinney64 (small blind) collected ($5.70)
Seat 4: dnagel222 (big blind) folded on the Flop
Seat 5: mrdust1 folded before Flop (didn't bet)
Seat 6: ColonelPhorbin folded on the Flop


PokerStars Hand #232992394869:  Hold'em No Limit ($1/$2 USD) - 2022/01/16 12:23:06 ET
Table 'Atalante' 6-max Seat #3 is the button
Seat 1: iknewyouhadit ($249.62 in chips)
Seat 2: CharlieM84 ($371.33 in chips)
Seat 3: rkinney64 ($244.17 in chips)
Seat 4: dnagel222 ($118 in chips)
Seat 5: mrdust1 ($200 in chips)
Seat 6: ColonelPhorbin ($194.15 in chips)
dnagel222: posts small blind $1
mrdust1: posts big blind $2
*** HOLE CARDS ***
ColonelPhorbin: folds
iknewyouhadit: folds
CharlieM84: folds
rkinney64: raises $2 to $4
dnagel222: folds
mrdust1: folds
Uncalled bet ($2) returned to rkinney64
rkinney64 collected $5 from pot
rkinney64: doesn't show hand
*** SUMMARY ***
Total pot $5 | Rake $0
Seat 1: iknewyouhadit folded before Flop (didn't bet)
Seat 2: CharlieM84 folded before Flop (didn't bet)
Seat 3: rkinney64 (button) collected ($5)
Seat 4: dnagel222 (small blind) folded before Flop
Seat 5: mrdust1 (big blind) folded before Flop
Seat 6: ColonelPhorbin folded before Flop (didn't bet)


PokerStars Hand #232992394946:  Hold'em No Limit ($1/$2 USD) - 2022/01/16 12:23:21 ET
Table 'Atalante' 6-max Seat #4 is the button
Seat 1: iknewyouhadit ($249.62 in chips)
Seat 2: CharlieM84 ($371.33 in chips)
Seat 3: rkinney64 ($247.17 in chips)
Seat 4: dnagel222 ($117 in chips)
Seat 5: mrdust1 ($200 in chips)
Seat 6: ColonelPhorbin ($194.15 in chips)
mrdust1: posts small blind $1
ColonelPhorbin: posts big blind $2
*** HOLE CARDS ***
iknewyouhadit: folds
CharlieM84: folds
rkinney64: folds
dnagel222: folds
mrdust1: raises $4.60 to $6.60
ColonelPhorbin: calls $4.60
*** FLOP *** [3s Qd 2h]
mrdust1: bets $5.52
ColonelPhorbin: calls $5.52
*** TURN *** [3s Qd 2h] [Td]
mrdust1: bets $15.43
ColonelPhorbin: folds
Uncalled bet ($15.43) returned to mrdust1
mrdust1 collected $23.03 from pot
mrdust1: doesn't show hand
*** SUMMARY ***
Total pot $24.24 | Rake $1.21
Board [3s Qd 2h Td]
Seat 1: iknewyouhadit folded before Flop (didn't bet)
Seat 2: CharlieM84 folded before Flop (didn't bet)
Seat 3: rkinney64 folded before Flop (didn't bet)
Seat 4: dnagel222 (button) folded before Flop (didn't bet)
Seat 5: mrdust1 (small blind) collected ($23.03)
Seat 6: ColonelPhorbin (big blind) folded on the Turn


PokerStars Hand #232992395253:  Hold'em No Limit ($1/$2 USD) - 2022/01/16 12:24:14 ET
Table 'Atalante' 6-max Seat #5 is the button
Seat 1: iknewyouhadit ($249.62 in chips)
Seat 2: CharlieM84 ($371.33 in chips)
Seat 3: rkinney64 ($247.17 in chips)
Seat 4: dnagel222 ($117 in chips)
Seat 5: mrdust1 ($210.91 in chips)
Seat 6: ColonelPhorbin ($182.03 in chips)
ColonelPhorbin: posts small blind $1
iknewyouhadit: posts big blind $2
*** HOLE CARDS ***
CharlieM84: raises $3 to $5
rkinney64: folds
dnagel222: folds
mrdust1: folds
ColonelPhorbin: calls $4
iknewyouhadit: folds
*** FLOP *** [3c Ad Qs]
ColonelPhorbin: checks
CharlieM84: bets $3.76
ColonelPhorbin: folds
Uncalled bet ($3.76) returned to CharlieM84
CharlieM84 collected $11.40 from pot
CharlieM84: doesn't show hand
*** SUMMARY ***
Total pot $12 | Rake $0.60
Board [3c Ad Qs]
Seat 1: iknewyouhadit (big blind) folded before Flop
Seat 2: CharlieM84 collected ($11.40)
Seat 3: rkinney64 folded before Flop (didn't bet)
Seat 4: dnagel222 folded before Flop (didn't bet)
Seat 5: mrdust1 (button) folded before Flop (didn't bet)
Seat 6: ColonelPhorbin (small blind) folded on the Flop


PokerStars Hand #232992395409:  Hold'em No Limit ($1/$2 USD) - 2022/01/16 12:24:44 ET
Table 'Atalante' 6-max Seat #6 is the button
Seat 1: iknewyouhadit ($247.62 in chips)
Seat 2: CharlieM84 ($377.73 in chips)
Seat 3: rkinney64 ($247.17 in chips)
Seat 4: dnagel222 ($117 in chips)
Seat 5: mrdust1 ($210.91 in chips)
Seat 6: ColonelPhorbin ($177.03 in chips)
iknewyouhadit: posts small blind $1
CharlieM84: posts big blind $2
*** HOLE CARDS ***
rkinney64: folds
dnagel222 has timed out
dnagel222: folds
mrdust1: folds
ColonelPhorbin: raises $2 to $4
iknewyouhadit: raises $12 to $16
CharlieM84: folds
ColonelPhorbin: calls $12
*** FLOP *** [8h As 3c]
iknewyouhadit: bets $16.15
ColonelPhorbin: calls $16.15
*** TURN *** [8h As 3c] [5h]
iknewyouhadit: bets $48.11
ColonelPhorbin: folds
Uncalled bet ($48.11) returned to iknewyouhadit
iknewyouhadit collected $63.30 from pot
*** SUMMARY ***
Total pot $66.30 | Rake $3
Board [8h As 3c 5h]
Seat 1: iknewyouhadit (small blind) collected ($63.30)
Seat 2: CharlieM84 (big blind) folded before Flop
Seat 3: rkinney64 folded before Flop (didn't bet)
Seat 4: dnagel222 folded before Flop (didn't bet)
Seat 5: mrdust1 folded before Flop (didn't bet)
Seat 6: ColonelPhorbin (button) folded on the Turn


PokerStars Hand #232992395832:  Hold'em No Limit ($1/$2 USD) - 2022/01/16 12:26:03 ET
Table 'Atalante' 6-max Seat #1 is the button
Seat 1: iknewyouhadit ($278.77 in chips)
Seat 2: CharlieM84 ($375.73 in chips)
Seat 3: rkinney64 ($247.17 in chips)
Seat 5: mrdust1 ($210.91 in chips)
Seat 6: ColonelPhorbin ($144.88 in chips)
CharlieM84: posts small blind $1
rkinney64: posts big blind $2
*** HOLE CARDS ***
mrdust1: folds
ColonelPhorbin: folds
iknewyouhadit: raises $2.60 to $4.60
CharlieM84: folds
rkinney64: folds
Uncalled bet ($2.60) returned to iknewyouhadit
iknewyouhadit collected $5 from pot
*** SUMMARY ***
Total pot $5 | Rake $0
Seat 1: iknewyouhadit (button) collected ($5)
Seat 2: CharlieM84 (small blind) folded before Flop
Seat 3: rkinney64 (big blind) folded before Flop
Seat 5: mrdust1 folded before Flop (didn't bet)
Seat 6: ColonelPhorbin folded before Flop (didn't bet)


PokerStars Hand #232992395990:  Hold'em No Limit ($1/$2 USD) - 2022/01/16 12:26:34 ET
Table 'Atalante' 6-max Seat #2 is the button
Seat 1: iknewyouhadit ($281.77 in chips)
Seat 2: CharlieM84 ($374.73 in chips)
Seat 3: rkinney64 ($245.17 in chips)
Seat 5: mrdust1 ($210.91 in chips)
Seat 6: ColonelPhorbin ($144.88 in chips)
rkinney64: posts small blind $1
mrdust1: posts big blind $2
*** HOLE CARDS ***
ColonelPhorbin: raises $2 to $4
iknewyouhadit: folds
CharlieM84: folds
rkinney64: calls $3
mrdust1: folds
*** FLOP *** [4h 2d Qh]
rkinney64: checks
ColonelPhorbin: bets $9.50
rkinney64: folds
Uncalled bet ($9.50) returned to ColonelPhorbin
ColonelPhorbin collected $9.50 from pot
*** SUMMARY ***
Total pot $10 | Rake $0.50
Board [4h 2d Qh]
Seat 1: iknewyouhadit folded before Flop (didn't bet)
Seat 2: CharlieM84 (button) folded before Flop (didn't bet)
Seat 3: rkinney64 (small blind) folded on the Flop
Seat 5: mrdust1 (big blind) folded before Flop
Seat 6: ColonelPhorbin collected ($9.50)


PokerStars Hand #232992396177:  Hold'em No Limit ($1/$2 USD) - 2022/01/16 12:27:09 ET
Table 'Atalante' 6-max Seat #3 is the button
Seat 1: iknewyouhadit ($281.77 in chips)
Seat 2: CharlieM84 ($374.73 in chips)
Seat 3: rkinney64 ($241.17 in chips)
Seat 5: mrdust1 ($208.91 in chips)
Seat 6: ColonelPhorbin ($150.38 in chips)
mrdust1: posts small blind $1
ColonelPhorbin: posts big blind $2
*** HOLE CARDS ***
iknewyouhadit: folds
CharlieM84: folds
rkinney64: raises $4 to $6
mrdust1: folds
ColonelPhorbin: calls $4
*** FLOP *** [Tc Kc Kh]
ColonelPhorbin: bets $12.35
rkinney64: folds
Uncalled bet ($12.35) returned to ColonelPhorbin
ColonelPhorbin collected $12.35 from pot
*** SUMMARY ***
Total pot $13 | Rake $0.65
Board [Tc Kc Kh]
Seat 1: iknewyouhadit folded before Flop (didn't bet)
Seat 2: CharlieM84 folded before Flop (didn't bet)
Seat 3: rkinney64 (button) folded on the Flop
Seat 5: mrdust1 (small blind) folded before Flop
Seat 6: ColonelPhorbin (big blind) collected ($12.35)


PokerStars Hand #232992396322:  Hold'em No Limit ($1/$2 USD) - 2022/01/16 12:27:34 ET
Table 'Atalante' 6-max Seat #5 is the button
Seat 1: iknewyouhadit ($281.77 in chips)
Seat 2: CharlieM84 ($374.73 in chips)
Seat 3: rkinney64 ($235.17 in chips)
Seat 5: mrdust1 ($207.91 in chips)
Seat 6: ColonelPhorbin ($156.73 in chips)
ColonelPhorbin: posts small blind $1
iknewyouhadit: posts big blind $2
dnagel222: sits out
*** HOLE CARDS ***
CharlieM84: folds
rkinney64: folds
mrdust1: raises $3 to $5
ColonelPhorbin: calls $4
iknewyouhadit: raises $21 to $26
mrdust1: calls $21
ColonelPhorbin: folds
*** FLOP *** [Tc 5s 4d]
iknewyouhadit: checks
mrdust1: bets $23.83
iknewyouhadit: folds
Uncalled bet ($23.83) returned to mrdust1
mrdust1 collected $54.15 from pot
mrdust1: doesn't show hand
*** SUMMARY ***
Total pot $57 | Rake $2.85
Board [Tc 5s 4d]
Seat 1: iknewyouhadit (big blind) folded on the Flop
Seat 2: CharlieM84 folded before Flop (didn't bet)
Seat 3: rkinney64 folded before Flop (didn't bet)
Seat 5: mrdust1 (button) collected ($54.15)
Seat 6: ColonelPhorbin (small blind) folded before Flop


PokerStars Hand #232992396704:  Hold'em No Limit ($1/$2 USD) - 2022/01/16 12:28:45 ET
Table 'Atalante' 6-max Seat #6 is the button
Seat 1: iknewyouhadit ($255.77 in chips)
Seat 2: CharlieM84 ($374.73 in chips)
Seat 3: rkinney64 ($235.17 in chips)
Seat 5: mrdust1 ($236.06 in chips)
Seat 6: ColonelPhorbin ($151.73 in chips)
iknewyouhadit: posts small blind $1
CharlieM84: posts big blind $2
dnagel222: sits out
*** HOLE CARDS ***
rkinney64: raises $4 to $6
mrdust1: folds
ColonelPhorbin: calls $6
iknewyouhadit: folds
CharlieM84: calls $4
*** FLOP *** [2s Jh 3c]
CharlieM84: checks
rkinney64: bets $6
ColonelPhorbin: calls $6
CharlieM84: folds
*** TURN *** [2s Jh 3c] [Qd]
rkinney64: bets $16
ColonelPhorbin: calls $16
*** RIVER *** [2s Jh 3c Qd] [8s]
rkinney64: bets $40
ColonelPhorbin: raises $83.73 to $123.73 and is all-in
rkinney64: folds
Uncalled bet ($83.73) returned to ColonelPhorbin
ColonelPhorbin collected $140 from pot
*** SUMMARY ***
Total pot $143 | Rake $3
Board [2s Jh 3c Qd 8s]
Seat 1: iknewyouhadit (small blind) folded before Flop
Seat 2: CharlieM84 (big blind) folded on the Flop
Seat 3: rkinney64 folded on the River
Seat 5: mrdust1 folded before Flop (didn't bet)
Seat 6: ColonelPhorbin (button) collected ($140)


PokerStars Hand #232992397012:  Hold'em No Limit ($1/$2 USD) - 2022/01/16 12:29:42 ET
Table 'Atalante' 6-max Seat #1 is the button
Seat 1: iknewyouhadit ($254.77 in chips)
Seat 2: CharlieM84 ($368.73 in chips)
Seat 3: rkinney64 ($167.17 in chips)
Seat 5: mrdust1 ($236.06 in chips)
Seat 6: ColonelPhorbin ($223.73 in chips)
CharlieM84: posts small blind $1
rkinney64: posts big blind $2
dnagel222: sits out
*** HOLE CARDS ***
mrdust1: folds
ColonelPhorbin: calls $2
iknewyouhadit: raises $6 to $8
CharlieM84: raises $22 to $30
rkinney64: folds
ColonelPhorbin: folds
iknewyouhadit: folds
Uncalled bet ($22) returned to CharlieM84
CharlieM84 collected $20 from pot
CharlieM84: doesn't show hand
*** SUMMARY ***
Total pot $20 | Rake $0
Seat 1: iknewyouhadit (button) folded before Flop
Seat 2: CharlieM84 (small blind) collected ($20)
Seat 3: rkinney64 (big blind) folded before Flop
Seat 5: mrdust1 folded before Flop (didn't bet)
Seat 6: ColonelPhorbin folded before Flop


PokerStars Hand #232992397205:  Hold'em No Limit ($1/$2 USD) - 2022/01/16 12:30:16 ET
Table 'Atalante' 6-max Seat #2 is the button
Seat 1: iknewyouhadit ($246.77 in chips)
Seat 2: CharlieM84 ($380.73 in chips)
Seat 3: rkinney64 ($165.17 in chips)
Seat 4: dnagel222 ($117 in chips)
Seat 5: mrdust1 ($236.06 in chips)
Seat 6: ColonelPhorbin ($221.73 in chips)
rkinney64: posts small blind $1
dnagel222: posts big blind $2
*** HOLE CARDS ***
mrdust1: folds
ColonelPhorbin: raises $2 to $4
iknewyouhadit: folds
CharlieM84: folds
rkinney64: calls $3
dnagel222: calls $2
*** FLOP *** [2d 6h Th]
rkinney64: bets $10
dnagel222: calls $10
ColonelPhorbin: folds
*** TURN *** [2d 6h Th] [2s]
rkinney64: checks
dnagel222: bets $6
rkinney64: calls $6
*** RIVER *** [2d 6h Th 2s] [9d]
rkinney64: bets $14
dnagel222: calls $14
*** SHOW DOWN ***
rkinney64: shows [Js Ts] (two pair, Tens and Deuces)
dnagel222: mucks hand
rkinney64 collected $69 from pot
*** SUMMARY ***
Total pot $72 | Rake $3
Board [2d 6h Th 2s 9d]
Seat 1: iknewyouhadit folded before Flop (didn't bet)
Seat 2: CharlieM84 (button) folded before Flop (didn't bet)
Seat 3: rkinney64 (small blind) showed [Js Ts] and won ($69) with two pair, Tens and Deuces
Seat 4: dnagel222 (big blind) mucked
Seat 5: mrdust1 folded before Flop (didn't bet)
Seat 6: ColonelPhorbin folded on the Flop


PokerStars Hand #232992397520:  Hold'em No Limit ($1/$2 USD) - 2022/01/16 12:31:15 ET
Table 'Atalante' 6-max Seat #3 is the button
Seat 1: iknewyouhadit ($246.77 in chips)
Seat 2: CharlieM84 ($380.73 in chips)
Seat 3: rkinney64 ($200.17 in chips)
Seat 4: dnagel222 ($83 in chips)
Seat 5: mrdust1 ($236.06 in chips)
Seat 6: ColonelPhorbin ($217.73 in chips)
dnagel222: posts small blind $1
mrdust1: posts big blind $2
*** HOLE CARDS ***
ColonelPhorbin: raises $2 to $4
iknewyouhadit: folds
CharlieM84: folds
rkinney64: calls $4
dnagel222: calls $3
mrdust1: folds
*** FLOP *** [Qd 2d 6d]
dnagel222: checks
ColonelPhorbin: checks
rkinney64: checks
*** TURN *** [Qd 2d 6d] [2c]
dnagel222: checks
ColonelPhorbin: bets $13.30
rkinney64: calls $13.30
dnagel222: folds
*** RIVER *** [Qd 2d 6d 2c] [8d]
ColonelPhorbin: checks
rkinney64: bets $86
ColonelPhorbin: folds
Uncalled bet ($86) returned to rkinney64
rkinney64 collected $38.57 from pot
rkinney64: doesn't show hand
*** SUMMARY ***
Total pot $40.60 | Rake $2.03
Board [Qd 2d 6d 2c 8d]
Seat 1: iknewyouhadit folded before Flop (didn't bet)
Seat 2: CharlieM84 folded before Flop (didn't bet)
Seat 3: rkinney64 (button) collected ($38.57)
Seat 4: dnagel222 (small blind) folded on the Turn
Seat 5: mrdust1 (big blind) folded before Flop
Seat 6: ColonelPhorbin folded on the River


PokerStars Hand #232992397845:  Hold'em No Limit ($1/$2 USD) - 2022/01/16 12:32:17 ET
Table 'Atalante' 6-max Seat #4 is the button
Seat 1: iknewyouhadit ($246.77 in chips)
Seat 2: CharlieM84 ($380.73 in chips)
Seat 3: rkinney64 ($221.44 in chips)
Seat 4: dnagel222 ($79 in chips)
Seat 5: mrdust1 ($234.06 in chips)
Seat 6: ColonelPhorbin ($200.43 in chips)
mrdust1: posts small blind $1
ColonelPhorbin: posts big blind $2
*** HOLE CARDS ***
iknewyouhadit: folds
CharlieM84: raises $3 to $5
rkinney64 has timed out
rkinney64: folds
dnagel222: folds
mrdust1: folds
ColonelPhorbin: folds
Uncalled bet ($3) returned to CharlieM84
CharlieM84 collected $5 from pot
CharlieM84: doesn't show hand
*** SUMMARY ***
Total pot $5 | Rake $0
Seat 1: iknewyouhadit folded before Flop (didn't bet)
Seat 2: CharlieM84 collected ($5)
Seat 3: rkinney64 folded before Flop (didn't bet)
Seat 4: dnagel222 (button) folded before Flop (didn't bet)
Seat 5: mrdust1 (small blind) folded before Flop
Seat 6: ColonelPhorbin (big blind) folded before Flop


PokerStars Hand #232992398056:  Hold'em No Limit ($1/$2 USD) - 2022/01/16 12:32:54 ET
Table 'Atalante' 6-max Seat #5 is the button
Seat 1: iknewyouhadit ($246.77 in chips)
Seat 2: CharlieM84 ($383.73 in chips)
Seat 3: rkinney64 ($221.44 in chips)
Seat 4: dnagel222 ($79 in chips)
Seat 5: mrdust1 ($233.06 in chips)
Seat 6: ColonelPhorbin ($198.43 in chips)
ColonelPhorbin: posts small blind $1
iknewyouhadit: posts big blind $2
*** HOLE CARDS ***
CharlieM84: folds
rkinney64 has timed out
rkinney64: folds
dnagel222: folds
mrdust1: raises $3 to $5
ColonelPhorbin: calls $4
iknewyouhadit: folds
*** FLOP *** [8h 3c Kc]
rkinney64 leaves the table
ColonelPhorbin: checks
mrdust1: bets $3.76
ColonelPhorbin: calls $3.76
*** TURN *** [8h 3c Kc] [Jh]
ColonelPhorbin: checks
mrdust1: bets $14.09
ColonelPhorbin: folds
Uncalled bet ($14.09) returned to mrdust1
mrdust1 collected $18.54 from pot
mrdust1: doesn't show hand
*** SUMMARY ***
Total pot $19.52 | Rake $0.98
Board [8h 3c Kc Jh]
Seat 1: iknewyouhadit (big blind) folded before Flop
Seat 2: CharlieM84 folded before Flop (didn't bet)
Seat 3: rkinney64 folded before Flop (didn't bet)
Seat 4: dnagel222 folded before Flop (didn't bet)
Seat 5: mrdust1 (button) collected ($18.54)
Seat 6: ColonelPhorbin (small blind) folded on the Turn


PokerStars Hand #232992398412:  Hold'em No Limit ($1/$2 USD) - 2022/01/16 12:33:57 ET
Table 'Atalante' 6-max Seat #6 is the button
Seat 1: iknewyouhadit ($244.77 in chips)
Seat 2: CharlieM84 ($383.73 in chips)
Seat 4: dnagel222 ($79 in chips)
Seat 5: mrdust1 ($242.84 in chips)
Seat 6: ColonelPhorbin ($189.67 in chips)
iknewyouhadit: posts small blind $1
CharlieM84: posts big blind $2
*** HOLE CARDS ***
dnagel222: folds
mrdust1: folds
ColonelPhorbin: folds
iknewyouhadit: folds
Uncalled bet ($1) returned to CharlieM84
CharlieM84 collected $2 from pot
CharlieM84: doesn't show hand
*** SUMMARY ***
Total pot $2 | Rake $0
Seat 1: iknewyouhadit (small blind) folded before Flop
Seat 2: CharlieM84 (big blind) collected ($2)
Seat 4: dnagel222 folded before Flop (didn't bet)
Seat 5: mrdust1 folded before Flop (didn't bet)
Seat 6: ColonelPhorbin (button) folded before Flop (didn't bet)


PokerStars Hand #232992398471:  Hold'em No Limit ($1/$2 USD) - 2022/01/16 12:34:07 ET
Table 'Atalante' 6-max Seat #1 is the button
Seat 1: iknewyouhadit ($243.77 in chips)
Seat 2: CharlieM84 ($384.73 in chips)
Seat 4: dnagel222 ($79 in chips)
Seat 5: mrdust1 ($242.84 in chips)
Seat 6: ColonelPhorbin ($189.67 in chips)
CharlieM84: posts small blind $1
bazman125 joins the table at seat #3
dnagel222: posts big blind $2
*** HOLE CARDS ***
mrdust1: folds
ColonelPhorbin: folds
iknewyouhadit: folds
CharlieM84: raises $4 to $6
dnagel222: folds
Uncalled bet ($4) returned to CharlieM84
CharlieM84 collected $4 from pot
CharlieM84: doesn't show hand
*** SUMMARY ***
Total pot $4 | Rake $0
Seat 1: iknewyouhadit (button) folded before Flop (didn't bet)
Seat 2: CharlieM84 (small blind) collected ($4)
Seat 4: dnagel222 (big blind) folded before Flop
Seat 5: mrdust1 folded before Flop (didn't bet)
Seat 6: ColonelPhorbin folded before Flop (didn't bet)


PokerStars Hand #232992398615:  Hold'em No Limit ($1/$2 USD) - 2022/01/16 12:34:30 ET
Table 'Atalante' 6-max Seat #2 is the button
Seat 1: iknewyouhadit ($243.77 in chips)
Seat 2: CharlieM84 ($386.73 in chips)
Seat 4: dnagel222 ($77 in chips)
Seat 5: mrdust1 ($242.84 in chips)
Seat 6: ColonelPhorbin ($189.67 in chips)
dnagel222: posts small blind $1
mrdust1: posts big blind $2
*** HOLE CARDS ***
ColonelPhorbin: calls $2
iknewyouhadit: folds
CharlieM84: raises $4 to $6
dnagel222: folds
mrdust1: raises $24 to $30
ColonelPhorbin: folds
CharlieM84: calls $24
*** FLOP *** [4s 9s 2s]
mrdust1: checks
CharlieM84: bets $30
mrdust1: folds
Uncalled bet ($30) returned to CharlieM84
CharlieM84 collected $60 from pot
CharlieM84: doesn't show hand
*** SUMMARY ***
Total pot $63 | Rake $3
Board [4s 9s 2s]
Seat 1: iknewyouhadit folded before Flop (didn't bet)
Seat 2: CharlieM84 (button) collected ($60)
Seat 4: dnagel222 (small blind) folded before Flop
Seat 5: mrdust1 (big blind) folded on the Flop
Seat 6: ColonelPhorbin folded before Flop


PokerStars Hand #232992398876:  Hold'em No Limit ($1/$2 USD) - 2022/01/16 12:35:18 ET
Table 'Atalante' 6-max Seat #4 is the button
Seat 1: iknewyouhadit ($243.77 in chips)
Seat 2: CharlieM84 ($416.73 in chips)
Seat 4: dnagel222 ($76 in chips)
Seat 5: mrdust1 ($212.84 in chips)
Seat 6: ColonelPhorbin ($187.67 in chips)
mrdust1: posts small blind $1
ColonelPhorbin: posts big blind $2
bazman125: sits out
*** HOLE CARDS ***
iknewyouhadit: folds
CharlieM84: folds
dnagel222: folds
mrdust1: raises $4.60 to $6.60
ColonelPhorbin: calls $4.60
*** FLOP *** [Jh 9s 7s]
mrdust1: bets $8.40
ColonelPhorbin: folds
Uncalled bet ($8.40) returned to mrdust1
mrdust1 collected $12.54 from pot
mrdust1: doesn't show hand
*** SUMMARY ***
Total pot $13.20 | Rake $0.66
Board [Jh 9s 7s]
Seat 1: iknewyouhadit folded before Flop (didn't bet)
Seat 2: CharlieM84 folded before Flop (didn't bet)
Seat 4: dnagel222 (button) folded before Flop (didn't bet)
Seat 5: mrdust1 (small blind) collected ($12.54)
Seat 6: ColonelPhorbin (big blind) folded on the Flop


PokerStars Hand #232992399107:  Hold'em No Limit ($1/$2 USD) - 2022/01/16 12:35:57 ET
Table 'Atalante' 6-max Seat #5 is the button
Seat 1: iknewyouhadit ($243.77 in chips)
Seat 2: CharlieM84 ($416.73 in chips)
Seat 4: dnagel222 ($76 in chips)
Seat 5: mrdust1 ($218.78 in chips)
Seat 6: ColonelPhorbin ($181.07 in chips)
ColonelPhorbin: posts small blind $1
iknewyouhadit: posts big blind $2
bazman125: sits out
*** HOLE CARDS ***
CharlieM84: folds
dnagel222: raises $2 to $4
mrdust1: folds
ColonelPhorbin: calls $3
iknewyouhadit: calls $2
*** FLOP *** [6d 5d Js]
ColonelPhorbin: bets $11.40
iknewyouhadit: folds
dnagel222: folds
Uncalled bet ($11.40) returned to ColonelPhorbin
ColonelPhorbin collected $11.40 from pot
*** SUMMARY ***
Total pot $12 | Rake $0.60
Board [6d 5d Js]
Seat 1: iknewyouhadit (big blind) folded on the Flop
Seat 2: CharlieM84 folded before Flop (didn't bet)
Seat 4: dnagel222 folded on the Flop
Seat 5: mrdust1 (button) folded before Flop (didn't bet)
Seat 6: ColonelPhorbin (small blind) collected ($11.40)


PokerStars Hand #232992399342:  Hold'em No Limit ($1/$2 USD) - 2022/01/16 12:36:40 ET
Table 'Atalante' 6-max Seat #6 is the button
Seat 1: iknewyouhadit ($239.77 in chips)
Seat 2: CharlieM84 ($416.73 in chips)
Seat 4: dnagel222 ($72 in chips)
Seat 5: mrdust1 ($218.78 in chips)
Seat 6: ColonelPhorbin ($188.47 in chips)
iknewyouhadit: posts small blind $1
CharlieM84: posts big blind $2
bazman125: sits out
*** HOLE CARDS ***
dnagel222: calls $2
mrdust1: folds
ColonelPhorbin: calls $2
iknewyouhadit: folds
CharlieM84: checks
*** FLOP *** [3c Kh 2h]
CharlieM84: checks
dnagel222: bets $2
ColonelPhorbin: calls $2
CharlieM84: folds
*** TURN *** [3c Kh 2h] [Th]
dnagel222: checks
ColonelPhorbin: bets $10.45
dnagel222: folds
Uncalled bet ($10.45) returned to ColonelPhorbin
ColonelPhorbin collected $10.45 from pot
*** SUMMARY ***
Total pot $11 | Rake $0.55
Board [3c Kh 2h Th]
Seat 1: iknewyouhadit (small blind) folded before Flop
Seat 2: CharlieM84 (big blind) folded on the Flop
Seat 4: dnagel222 folded on the Turn
Seat 5: mrdust1 folded before Flop (didn't bet)
Seat 6: ColonelPhorbin (button) collected ($10.45)


PokerStars Hand #232992399590:  Hold'em No Limit ($1/$2 USD) - 2022/01/16 12:37:26 ET
Table 'Atalante' 6-max Seat #1 is the button
Seat 1: iknewyouhadit ($238.77 in chips)
Seat 2: CharlieM84 ($414.73 in chips)
Seat 3: bazman125 ($100.04 in chips)
Seat 4: dnagel222 ($68 in chips)
Seat 5: mrdust1 ($218.78 in chips)
Seat 6: ColonelPhorbin ($194.92 in chips)
CharlieM84: posts small blind $1
bazman125: posts big blind $2
*** HOLE CARDS ***
dnagel222: calls $2
mrdust1: folds
ColonelPhorbin: folds
iknewyouhadit: folds
CharlieM84: folds
bazman125: raises $8 to $10
dnagel222: calls $8
*** FLOP *** [Ac 9s Kd]
bazman125: bets $9.98
dnagel222: folds
Uncalled bet ($9.98) returned to bazman125
bazman125 collected $19.95 from pot
*** SUMMARY ***
Total pot $21 | Rake $1.05
Board [Ac 9s Kd]
Seat 1: iknewyouhadit (button) folded before Flop (didn't bet)
Seat 2: CharlieM84 (small blind) folded before Flop
Seat 3: bazman125 (big blind) collected ($19.95)
Seat 4: dnagel222 folded on the Flop
Seat 5: mrdust1 folded before Flop (didn't bet)
Seat 6: ColonelPhorbin folded before Flop (didn't bet)


PokerStars Hand #232992399789:  Hold'em No Limit ($1/$2 USD) - 2022/01/16 12:38:03 ET
Table 'Atalante' 6-max Seat #2 is the button
Seat 1: iknewyouhadit ($238.77 in chips)
Seat 2: CharlieM84 ($413.73 in chips)
Seat 3: bazman125 ($109.99 in chips)
Seat 4: dnagel222 ($58 in chips)
Seat 5: mrdust1 ($218.78 in chips)
Seat 6: ColonelPhorbin ($194.92 in chips)
bazman125: posts small blind $1
dnagel222: posts big blind $2
*** HOLE CARDS ***
mrdust1: folds
ColonelPhorbin: raises $2 to $4
iknewyouhadit: folds
CharlieM84: folds
bazman125: folds
dnagel222: folds
Uncalled bet ($2) returned to ColonelPhorbin
ColonelPhorbin collected $5 from pot
*** SUMMARY ***
Total pot $5 | Rake $0
Seat 1: iknewyouhadit folded before Flop (didn't bet)
Seat 2: CharlieM84 (button) folded before Flop (didn't bet)
Seat 3: bazman125 (small blind) folded before Flop
Seat 4: dnagel222 (big blind) folded before Flop
Seat 5: mrdust1 folded before Flop (didn't bet)
Seat 6: ColonelPhorbin collected ($5)


PokerStars Hand #232992399908:  Hold'em No Limit ($1/$2 USD) - 2022/01/16 12:38:24 ET
Table 'Atalante' 6-max Seat #3 is the button
Seat 1: iknewyouhadit ($238.77 in chips)
Seat 2: CharlieM84 ($413.73 in chips)
Seat 3: bazman125 ($108.99 in chips)
Seat 4: dnagel222 ($56 in chips)
Seat 5: mrdust1 ($218.78 in chips)
Seat 6: ColonelPhorbin ($197.92 in chips)
dnagel222: posts small blind $1
mrdust1: posts big blind $2
*** HOLE CARDS ***
ColonelPhorbin: calls $2
iknewyouhadit: folds
CharlieM84: folds
bazman125: folds
dnagel222: folds
mrdust1: checks
*** FLOP *** [6s 9c Kc]
mrdust1: checks
ColonelPhorbin: checks
*** TURN *** [6s 9c Kc] [2c]
mrdust1: bets $2
ColonelPhorbin: folds
Uncalled bet ($2) returned to mrdust1
mrdust1 collected $4.75 from pot
mrdust1: doesn't show hand
*** SUMMARY ***
Total pot $5 | Rake $0.25
Board [6s 9c Kc 2c]
Seat 1: iknewyouhadit folded before Flop (didn't bet)
Seat 2: CharlieM84 folded before Flop (didn't bet)
Seat 3: bazman125 (button) folded before Flop (didn't bet)
Seat 4: dnagel222 (small blind) folded before Flop
Seat 5: mrdust1 (big blind) collected ($4.75)
Seat 6: ColonelPhorbin folded on the Turn


PokerStars Hand #232992675146:  Hold'em No Limit ($1/$2 USD) - 2022/01/16 12:38:50 ET
Table 'Atalante' 6-max Seat #4 is the button
Seat 1: iknewyouhadit ($238.77 in chips)
Seat 2: CharlieM84 ($413.73 in chips)
Seat 3: bazman125 ($108.99 in chips)
Seat 4: dnagel222 ($55 in chips)
Seat 5: mrdust1 ($221.53 in chips)
Seat 6: ColonelPhorbin ($195.92 in chips)
mrdust1: posts small blind $1
ColonelPhorbin: posts big blind $2
*** HOLE CARDS ***
iknewyouhadit: folds
CharlieM84: folds
bazman125: folds
dnagel222: calls $2
mrdust1: folds
ColonelPhorbin: raises $2 to $4
dnagel222: calls $2
*** FLOP *** [6s Ks 9h]
ColonelPhorbin: bets $4.28
dnagel222: folds
Uncalled bet ($4.28) returned to ColonelPhorbin
ColonelPhorbin collected $8.55 from pot
*** SUMMARY ***
Total pot $9 | Rake $0.45
Board [6s Ks 9h]
Seat 1: iknewyouhadit folded before Flop (didn't bet)
Seat 2: CharlieM84 folded before Flop (didn't bet)
Seat 3: bazman125 folded before Flop (didn't bet)
Seat 4: dnagel222 (button) folded on the Flop
Seat 5: mrdust1 (small blind) folded before Flop
Seat 6: ColonelPhorbin (big blind) collected ($8.55)


PokerStars Hand #232992675465:  Hold'em No Limit ($1/$2 USD) - 2022/01/16 12:39:49 ET
Table 'Atalante' 6-max Seat #5 is the button
Seat 1: iknewyouhadit ($238.77 in chips)
Seat 2: CharlieM84 ($413.73 in chips)
Seat 3: bazman125 ($108.99 in chips)
Seat 4: dnagel222 ($51 in chips)
Seat 5: mrdust1 ($220.53 in chips)
Seat 6: ColonelPhorbin ($200.47 in chips)
ColonelPhorbin: posts small blind $1
iknewyouhadit: posts big blind $2
*** HOLE CARDS ***
CharlieM84: folds
bazman125: folds
dnagel222: folds
mrdust1: raises $3 to $5
ColonelPhorbin: calls $4
iknewyouhadit: folds
*** FLOP *** [4h 8s 8d]
ColonelPhorbin: checks
mrdust1: bets $3.76
ColonelPhorbin: calls $3.76
*** TURN *** [4h 8s 8d] [4d]
ColonelPhorbin: checks
mrdust1: bets $12.42
ColonelPhorbin: calls $12.42
*** RIVER *** [4h 8s 8d 4d] [7h]
ColonelPhorbin: bets $42.14
mrdust1: folds
Uncalled bet ($42.14) returned to ColonelPhorbin
ColonelPhorbin collected $42.14 from pot
*** SUMMARY ***
Total pot $44.36 | Rake $2.22
Board [4h 8s 8d 4d 7h]
Seat 1: iknewyouhadit (big blind) folded before Flop
Seat 2: CharlieM84 folded before Flop (didn't bet)
Seat 3: bazman125 folded before Flop (didn't bet)
Seat 4: dnagel222 folded before Flop (didn't bet)
Seat 5: mrdust1 (button) folded on the River
Seat 6: ColonelPhorbin (small blind) collected ($42.14)


PokerStars Hand #232992675830:  Hold'em No Limit ($1/$2 USD) - 2022/01/16 12:40:53 ET
Table 'Atalante' 6-max Seat #6 is the button
Seat 1: iknewyouhadit ($236.77 in chips)
Seat 3: bazman125 ($108.99 in chips)
Seat 4: dnagel222 ($51 in chips)
Seat 5: mrdust1 ($200 in chips)
Seat 6: ColonelPhorbin ($221.43 in chips)
iknewyouhadit: posts small blind $1
CharlieM84: is sitting out
bazman125: posts big blind $2
*** HOLE CARDS ***
dnagel222: calls $2
mrdust1: raises $4.60 to $6.60
ColonelPhorbin: folds
iknewyouhadit: folds
bazman125: folds
dnagel222: folds
Uncalled bet ($4.60) returned to mrdust1
mrdust1 collected $7 from pot
mrdust1: doesn't show hand
*** SUMMARY ***
Total pot $7 | Rake $0
Seat 1: iknewyouhadit (small blind) folded before Flop
Seat 3: bazman125 (big blind) folded before Flop
Seat 4: dnagel222 folded before Flop
Seat 5: mrdust1 collected ($7)
Seat 6: ColonelPhorbin (button) folded before Flop (didn't bet)


PokerStars Hand #232992676041:  Hold'em No Limit ($1/$2 USD) - 2022/01/16 12:41:29 ET
Table 'Atalante' 6-max Seat #1 is the button
Seat 1: iknewyouhadit ($235.77 in chips)
Seat 3: bazman125 ($106.99 in chips)
Seat 4: dnagel222 ($49 in chips)
Seat 5: mrdust1 ($205 in chips)
Seat 6: ColonelPhorbin ($221.43 in chips)
bazman125: posts small blind $1
dnagel222: posts big blind $2
*** HOLE CARDS ***
mrdust1: folds
ColonelPhorbin: raises $2 to $4
iknewyouhadit: raises $11 to $15
bazman125: folds
dnagel222: folds
ColonelPhorbin: calls $11
*** FLOP *** [7h 5c 2h]
ColonelPhorbin: checks
iknewyouhadit: checks
*** TURN *** [7h 5c 2h] [2d]
ColonelPhorbin: checks
iknewyouhadit: checks
*** RIVER *** [7h 5c 2h 2d] [Kh]
ColonelPhorbin: bets $31.35
iknewyouhadit: calls $31.35
*** SHOW DOWN ***
ColonelPhorbin: shows [Jh Ks] (two pair, Kings and Deuces)
iknewyouhadit: shows [As Kd] (two pair, Kings and Deuces - Ace kicker)
iknewyouhadit collected $92.70 from pot
*** SUMMARY ***
Total pot $95.70 | Rake $3
Board [7h 5c 2h 2d Kh]
Seat 1: iknewyouhadit (button) showed [As Kd] and won ($92.70) with two pair, Kings and Deuces
Seat 3: bazman125 (small blind) folded before Flop
Seat 4: dnagel222 (big blind) folded before Flop
Seat 5: mrdust1 folded before Flop (didn't bet)
Seat 6: ColonelPhorbin showed [Jh Ks] and lost with two pair, Kings and Deuces


PokerStars Hand #232992676285:  Hold'em No Limit ($1/$2 USD) - 2022/01/16 12:42:12 ET
Table 'Atalante' 6-max Seat #3 is the button
Seat 1: iknewyouhadit ($282.12 in chips)
Seat 3: bazman125 ($105.99 in chips)
Seat 4: dnagel222 ($47 in chips)
Seat 5: mrdust1 ($205 in chips)
Seat 6: ColonelPhorbin ($175.08 in chips)
dnagel222: posts small blind $1
mrdust1: posts big blind $2
*** HOLE CARDS ***
ColonelPhorbin: folds
iknewyouhadit: raises $2.60 to $4.60
bazman125: folds
dnagel222: folds
mrdust1: calls $2.60
*** FLOP *** [Kd 4d 8h]
mrdust1: checks
iknewyouhadit: bets $4.20
mrdust1: calls $4.20
*** TURN *** [Kd 4d 8h] [Qc]
mrdust1: checks
iknewyouhadit: bets $13.43
mrdust1: calls $13.43
*** RIVER *** [Kd 4d 8h Qc] [5s]
mrdust1: checks
iknewyouhadit: checks
*** SHOW DOWN ***
mrdust1: shows [Kh 6h] (a pair of Kings)
iknewyouhadit: mucks hand
mrdust1 collected $43.19 from pot
*** SUMMARY ***
Total pot $45.46 | Rake $2.27
Board [Kd 4d 8h Qc 5s]
Seat 1: iknewyouhadit mucked
Seat 3: bazman125 (button) folded before Flop (didn't bet)
Seat 4: dnagel222 (small blind) folded before Flop
Seat 5: mrdust1 (big blind) showed [Kh 6h] and won ($43.19) with a pair of Kings
Seat 6: ColonelPhorbin folded before Flop (didn't bet)


PokerStars Hand #232992676693:  Hold'em No Limit ($1/$2 USD) - 2022/01/16 12:43:26 ET
Table 'Atalante' 6-max Seat #4 is the button
Seat 1: iknewyouhadit ($259.89 in chips)
Seat 3: bazman125 ($105.99 in chips)
Seat 4: dnagel222 ($46 in chips)
Seat 5: mrdust1 ($225.96 in chips)
Seat 6: ColonelPhorbin ($175.08 in chips)
mrdust1: posts small blind $1
ColonelPhorbin: posts big blind $2
*** HOLE CARDS ***
iknewyouhadit: folds
bazman125: folds
dnagel222: folds
mrdust1: raises $4.60 to $6.60
ColonelPhorbin: calls $4.60
*** FLOP *** [8s 3d Ks]
mrdust1: bets $4.14
ColonelPhorbin: calls $4.14
*** TURN *** [8s 3d Ks] [Ah]
mrdust1: bets $13.67
ColonelPhorbin: calls $13.67
*** RIVER *** [8s 3d Ks Ah] [3h]
mrdust1: bets $31.07
ColonelPhorbin: calls $31.07
*** SHOW DOWN ***
mrdust1: shows [9h As] (two pair, Aces and Threes)
ColonelPhorbin: mucks hand
mrdust1 collected $107.96 from pot
*** SUMMARY ***
Total pot $110.96 | Rake $3
Board [8s 3d Ks Ah 3h]
Seat 1: iknewyouhadit folded before Flop (didn't bet)
Seat 3: bazman125 folded before Flop (didn't bet)
Seat 4: dnagel222 (button) folded before Flop (didn't bet)
Seat 5: mrdust1 (small blind) showed [9h As] and won ($107.96) with two pair, Aces and Threes
Seat 6: ColonelPhorbin (big blind) mucked


PokerStars Hand #232992677185:  Hold'em No Limit ($1/$2 USD) - 2022/01/16 12:44:53 ET
Table 'Atalante' 6-max Seat #5 is the button
Seat 1: iknewyouhadit ($259.89 in chips)
Seat 3: bazman125 ($105.99 in chips)
Seat 4: dnagel222 ($46 in chips)
Seat 5: mrdust1 ($278.44 in chips)
Seat 6: ColonelPhorbin ($119.60 in chips)
ColonelPhorbin: posts small blind $1
iknewyouhadit: posts big blind $2
*** HOLE CARDS ***
bazman125: folds
dnagel222: calls $2
mrdust1 has timed out
mrdust1: folds
ColonelPhorbin: calls $1
iknewyouhadit: checks
*** FLOP *** [7h Js Qc]
CharlieM84 leaves the table
ColonelPhorbin: checks
reynaldo1244 joins the table at seat #2
iknewyouhadit: checks
dnagel222: checks
*** TURN *** [7h Js Qc] [2d]
ColonelPhorbin: checks
iknewyouhadit: checks
dnagel222: bets $5.70
ColonelPhorbin: folds
iknewyouhadit: folds
Uncalled bet ($5.70) returned to dnagel222
dnagel222 collected $5.70 from pot
*** SUMMARY ***
Total pot $6 | Rake $0.30
Board [7h Js Qc 2d]
Seat 1: iknewyouhadit (big blind) folded on the Turn
Seat 3: bazman125 folded before Flop (didn't bet)
Seat 4: dnagel222 collected ($5.70)
Seat 5: mrdust1 (button) folded before Flop (didn't bet)
Seat 6: ColonelPhorbin (small blind) folded on the Turn


PokerStars Hand #232992677624:  Hold'em No Limit ($1/$2 USD) - 2022/01/16 12:46:09 ET
Table 'Atalante' 6-max Seat #6 is the button
Seat 1: iknewyouhadit ($257.89 in chips)
Seat 2: reynaldo1244 ($200 in chips)
Seat 3: bazman125 ($105.99 in chips)
Seat 4: dnagel222 ($49.70 in chips)
Seat 5: mrdust1 ($278.44 in chips)
Seat 6: ColonelPhorbin ($117.60 in chips)
iknewyouhadit: posts small blind $1
reynaldo1244: posts big blind $2
*** HOLE CARDS ***
bazman125: folds
dnagel222: calls $2
mrdust1: raises $4.60 to $6.60
ColonelPhorbin: calls $6.60
iknewyouhadit: folds
reynaldo1244: folds
dnagel222: calls $4.60
*** FLOP *** [Kc 7h Qh]
dnagel222: checks
mrdust1: bets $7.15
ColonelPhorbin: calls $7.15
dnagel222: calls $7.15
*** TURN *** [Kc 7h Qh] [6s]
dnagel222: checks
mrdust1: checks
ColonelPhorbin: bets $21.02
dnagel222: folds
mrdust1: folds
Uncalled bet ($21.02) returned to ColonelPhorbin
ColonelPhorbin collected $42.04 from pot
*** SUMMARY ***
Total pot $44.25 | Rake $2.21
Board [Kc 7h Qh 6s]
Seat 1: iknewyouhadit (small blind) folded before Flop
Seat 2: reynaldo1244 (big blind) folded before Flop
Seat 3: bazman125 folded before Flop (didn't bet)
Seat 4: dnagel222 folded on the Turn
Seat 5: mrdust1 folded on the Turn
Seat 6: ColonelPhorbin (button) collected ($42.04)


PokerStars Hand #232992678045:  Hold'em No Limit ($1/$2 USD) - 2022/01/16 12:47:21 ET
Table 'Atalante' 6-max Seat #1 is the button
Seat 1: iknewyouhadit ($256.89 in chips)
Seat 2: reynaldo1244 ($200 in chips)
Seat 3: bazman125 ($105.99 in chips)
Seat 4: dnagel222 ($35.95 in chips)
Seat 5: mrdust1 ($264.69 in chips)
Seat 6: ColonelPhorbin ($145.89 in chips)
reynaldo1244: posts small blind $1
bazman125: posts big blind $2
*** HOLE CARDS ***
dnagel222: raises $5 to $7
mrdust1: folds
ColonelPhorbin: folds
iknewyouhadit: folds
reynaldo1244: folds
bazman125: folds
Uncalled bet ($5) returned to dnagel222
dnagel222 collected $5 from pot
*** SUMMARY ***
Total pot $5 | Rake $0
Seat 1: iknewyouhadit (button) folded before Flop (didn't bet)
Seat 2: reynaldo1244 (small blind) folded before Flop
Seat 3: bazman125 (big blind) folded before Flop
Seat 4: dnagel222 collected ($5)
Seat 5: mrdust1 folded before Flop (didn't bet)
Seat 6: ColonelPhorbin folded before Flop (didn't bet)


PokerStars Hand #232992678138:  Hold'em No Limit ($1/$2 USD) - 2022/01/16 12:47:35 ET
Table 'Atalante' 6-max Seat #2 is the button
Seat 1: iknewyouhadit ($256.89 in chips)
Seat 2: reynaldo1244 ($200 in chips)
Seat 3: bazman125 ($103.99 in chips)
Seat 4: dnagel222 ($38.95 in chips)
Seat 5: mrdust1 ($264.69 in chips)
Seat 6: ColonelPhorbin ($145.89 in chips)
bazman125: posts small blind $1
dnagel222: posts big blind $2
*** HOLE CARDS ***
mrdust1: folds
ColonelPhorbin: raises $2 to $4
iknewyouhadit: folds
reynaldo1244: folds
bazman125: folds
dnagel222: folds
Uncalled bet ($2) returned to ColonelPhorbin
dnagel222 leaves the table
ColonelPhorbin collected $5 from pot
*** SUMMARY ***
Total pot $5 | Rake $0
Seat 1: iknewyouhadit folded before Flop (didn't bet)
Seat 2: reynaldo1244 (button) folded before Flop (didn't bet)
Seat 3: bazman125 (small blind) folded before Flop
Seat 4: dnagel222 (big blind) folded before Flop
Seat 5: mrdust1 folded before Flop (didn't bet)
Seat 6: ColonelPhorbin collected ($5)


PokerStars Hand #232992678253:  Hold'em No Limit ($1/$2 USD) - 2022/01/16 12:47:56 ET
Table 'Atalante' 6-max Seat #3 is the button
Seat 1: iknewyouhadit ($256.89 in chips)
Seat 2: reynaldo1244 ($200 in chips)
Seat 3: bazman125 ($102.99 in chips)
Seat 5: mrdust1 ($264.69 in chips)
Seat 6: ColonelPhorbin ($148.89 in chips)
mrdust1: posts small blind $1
ColonelPhorbin: posts big blind $2
*** HOLE CARDS ***
iknewyouhadit: raises $2.60 to $4.60
reynaldo1244: folds
bazman125: folds
mrdust1: folds
ColonelPhorbin: calls $2.60
*** FLOP *** [Kc 3c Qh]
ColonelPhorbin: checks
iknewyouhadit: bets $4.85
ColonelPhorbin: folds
Uncalled bet ($4.85) returned to iknewyouhadit
iknewyouhadit collected $9.69 from pot
*** SUMMARY ***
Total pot $10.20 | Rake $0.51
Board [Kc 3c Qh]
Seat 1: iknewyouhadit collected ($9.69)
Seat 2: reynaldo1244 folded before Flop (didn't bet)
Seat 3: bazman125 (button) folded before Flop (didn't bet)
Seat 5: mrdust1 (small blind) folded before Flop
Seat 6: ColonelPhorbin (big blind) folded on the Flop


PokerStars Hand #232992678427:  Hold'em No Limit ($1/$2 USD) - 2022/01/16 12:48:25 ET
Table 'Atalante' 6-max Seat #5 is the button
Seat 1: iknewyouhadit ($261.98 in chips)
Seat 2: reynaldo1244 ($200 in chips)
Seat 3: bazman125 ($102.99 in chips)
Seat 5: mrdust1 ($263.69 in chips)
Seat 6: ColonelPhorbin ($144.29 in chips)
ColonelPhorbin: posts small blind $1
iknewyouhadit: posts big blind $2
*** HOLE CARDS ***
reynaldo1244: folds
bazman125: folds
mrdust1: raises $3 to $5
ColonelPhorbin: folds
iknewyouhadit: folds
Uncalled bet ($3) returned to mrdust1
mrdust1 collected $5 from pot
mrdust1: doesn't show hand
*** SUMMARY ***
Total pot $5 | Rake $0
Seat 1: iknewyouhadit (big blind) folded before Flop
Seat 2: reynaldo1244 folded before Flop (didn't bet)
Seat 3: bazman125 folded before Flop (didn't bet)
Seat 5: mrdust1 (button) collected ($5)
Seat 6: ColonelPhorbin (small blind) folded before Flop


PokerStars Hand #232992678522:  Hold'em No Limit ($1/$2 USD) - 2022/01/16 12:48:43 ET
Table 'Atalante' 6-max Seat #6 is the button
Seat 1: iknewyouhadit ($259.98 in chips)
Seat 2: reynaldo1244 ($200 in chips)
Seat 3: bazman125 ($102.99 in chips)
Seat 5: mrdust1 ($266.69 in chips)
Seat 6: ColonelPhorbin ($143.29 in chips)
iknewyouhadit: posts small blind $1
reynaldo1244: posts big blind $2
*** HOLE CARDS ***
bazman125: calls $2
mrdust1: folds
ColonelPhorbin: calls $2
iknewyouhadit: folds
reynaldo1244: checks
*** FLOP *** [2c Js Ah]
reynaldo1244: checks
bazman125: bets $2
ColonelPhorbin: raises $5.33 to $7.33
reynaldo1244: folds
bazman125: calls $5.33
*** TURN *** [2c Js Ah] [5c]
bazman125: checks
ColonelPhorbin: bets $10.29
bazman125: calls $10.29
*** RIVER *** [2c Js Ah 5c] [3d]
bazman125: checks
ColonelPhorbin: checks
*** SHOW DOWN ***
bazman125: shows [Kc Tc] (high card Ace)
ColonelPhorbin: shows [Jd 6s] (a pair of Jacks)
ColonelPhorbin collected $40.13 from pot
*** SUMMARY ***
Total pot $42.24 | Rake $2.11
Board [2c Js Ah 5c 3d]
Seat 1: iknewyouhadit (small blind) folded before Flop
Seat 2: reynaldo1244 (big blind) folded on the Flop
Seat 3: bazman125 showed [Kc Tc] and lost with high card Ace
Seat 5: mrdust1 folded before Flop (didn't bet)
Seat 6: ColonelPhorbin (button) showed [Jd 6s] and won ($40.13) with a pair of Jacks


PokerStars Hand #232992678755:  Hold'em No Limit ($1/$2 USD) - 2022/01/16 12:49:24 ET
Table 'Atalante' 6-max Seat #1 is the button
Seat 1: iknewyouhadit ($258.98 in chips)
Seat 2: reynaldo1244 ($200 in chips)
Seat 3: bazman125 ($83.37 in chips)
Seat 5: mrdust1 ($266.69 in chips)
Seat 6: ColonelPhorbin ($163.80 in chips)
reynaldo1244: posts small blind $1
bazman125: posts big blind $2
*** HOLE CARDS ***
rkinney64 joins the table at seat #4
mrdust1: folds
ColonelPhorbin: raises $2 to $4
iknewyouhadit: folds
reynaldo1244: folds
bazman125: calls $2
*** FLOP *** [2h 9h Ac]
bazman125: bets $2
ColonelPhorbin: calls $2
*** TURN *** [2h 9h Ac] [Qc]
bazman125: bets $12.35
ColonelPhorbin: folds
Uncalled bet ($12.35) returned to bazman125
bazman125 collected $12.35 from pot
*** SUMMARY ***
Total pot $13 | Rake $0.65
Board [2h 9h Ac Qc]
Seat 1: iknewyouhadit (button) folded before Flop (didn't bet)
Seat 2: reynaldo1244 (small blind) folded before Flop
Seat 3: bazman125 (big blind) collected ($12.35)
Seat 5: mrdust1 folded before Flop (didn't bet)
Seat 6: ColonelPhorbin folded on the Turn


PokerStars Hand #232992678907:  Hold'em No Limit ($1/$2 USD) - 2022/01/16 12:49:51 ET
Table 'Atalante' 6-max Seat #2 is the button
Seat 1: iknewyouhadit ($258.98 in chips)
Seat 2: reynaldo1244 ($200 in chips)
Seat 3: bazman125 ($89.72 in chips)
Seat 4: rkinney64 ($221.44 in chips)
Seat 5: mrdust1 ($266.69 in chips)
Seat 6: ColonelPhorbin ($157.80 in chips)
bazman125: posts small blind $1
rkinney64: posts big blind $2
*** HOLE CARDS ***
mrdust1: folds
ColonelPhorbin: raises $2 to $4
iknewyouhadit: folds
reynaldo1244: folds
bazman125: folds
rkinney64: calls $2
*** FLOP *** [Qs 9d 8s]
rkinney64: bets $4
ColonelPhorbin: calls $4
*** TURN *** [Qs 9d 8s] [Js]
rkinney64: bets $4
ColonelPhorbin: calls $4
*** RIVER *** [Qs 9d 8s Js] [9c]
rkinney64: bets $8
ColonelPhorbin: calls $8
*** SHOW DOWN ***
rkinney64: shows [Kc 9s] (three of a kind, Nines)
ColonelPhorbin: mucks hand
rkinney64 collected $38.95 from pot
*** SUMMARY ***
Total pot $41 | Rake $2.05
Board [Qs 9d 8s Js 9c]
Seat 1: iknewyouhadit folded before Flop (didn't bet)
Seat 2: reynaldo1244 (button) folded before Flop (didn't bet)
Seat 3: bazman125 (small blind) folded before Flop
Seat 4: rkinney64 (big blind) showed [Kc 9s] and won ($38.95) with three of a kind, Nines
Seat 5: mrdust1 folded before Flop (didn't bet)
Seat 6: ColonelPhorbin mucked


PokerStars Hand #232992679087:  Hold'em No Limit ($1/$2 USD) - 2022/01/16 12:50:25 ET
Table 'Atalante' 6-max Seat #3 is the button
Seat 1: iknewyouhadit ($258.98 in chips)
Seat 2: reynaldo1244 ($200 in chips)
Seat 3: bazman125 ($88.72 in chips)
Seat 4: rkinney64 ($240.39 in chips)
Seat 5: mrdust1 ($266.69 in chips)
Seat 6: ColonelPhorbin ($137.80 in chips)
rkinney64: posts small blind $1
mrdust1: posts big blind $2
*** HOLE CARDS ***
ColonelPhorbin: folds
iknewyouhadit: folds
reynaldo1244: raises $3 to $5
bazman125: folds
rkinney64: folds
mrdust1: calls $3
*** FLOP *** [Jh 3s 5h]
mrdust1: checks
reynaldo1244: bets $5.23
mrdust1: folds
Uncalled bet ($5.23) returned to reynaldo1244
reynaldo1244 collected $10.45 from pot
reynaldo1244: doesn't show hand
*** SUMMARY ***
Total pot $11 | Rake $0.55
Board [Jh 3s 5h]
Seat 1: iknewyouhadit folded before Flop (didn't bet)
Seat 2: reynaldo1244 collected ($10.45)
Seat 3: bazman125 (button) folded before Flop (didn't bet)
Seat 4: rkinney64 (small blind) folded before Flop
Seat 5: mrdust1 (big blind) folded on the Flop
Seat 6: ColonelPhorbin folded before Flop (didn't bet)


PokerStars Hand #232992679343:  Hold'em No Limit ($1/$2 USD) - 2022/01/16 12:51:13 ET
Table 'Atalante' 6-max Seat #4 is the button
Seat 1: iknewyouhadit ($258.98 in chips)
Seat 2: reynaldo1244 ($205.45 in chips)
Seat 3: bazman125 ($88.72 in chips)
Seat 4: rkinney64 ($239.39 in chips)
Seat 5: mrdust1 ($261.69 in chips)
Seat 6: ColonelPhorbin ($137.80 in chips)
mrdust1: posts small blind $1
ColonelPhorbin: posts big blind $2
*** HOLE CARDS ***
iknewyouhadit: raises $2.60 to $4.60
reynaldo1244: folds
bazman125: calls $4.60
rkinney64: folds
mrdust1: raises $21.40 to $26
ColonelPhorbin: folds
iknewyouhadit: raises $44 to $70
bazman125: folds
mrdust1: calls $44
*** FLOP *** [Td 8d 4h]
mrdust1: checks
iknewyouhadit: bets $188.98 and is all-in
mrdust1: folds
Uncalled bet ($188.98) returned to iknewyouhadit
iknewyouhadit collected $143.60 from pot
*** SUMMARY ***
Total pot $146.60 | Rake $3
Board [Td 8d 4h]
Seat 1: iknewyouhadit collected ($143.60)
Seat 2: reynaldo1244 folded before Flop (didn't bet)
Seat 3: bazman125 folded before Flop
Seat 4: rkinney64 (button) folded before Flop (didn't bet)
Seat 5: mrdust1 (small blind) folded on the Flop
Seat 6: ColonelPhorbin (big blind) folded before Flop


PokerStars Hand #232992822993:  Hold'em No Limit ($1/$2 USD) - 2022/01/16 12:53:38 ET
Table 'Atalante' 6-max Seat #5 is the button
Seat 2: reynaldo1244 ($205.45 in chips)
Seat 3: bazman125 ($84.12 in chips)
Seat 4: rkinney64 ($239.39 in chips)
Seat 5: mrdust1 ($200 in chips)
Seat 6: ColonelPhorbin ($135.80 in chips)
ColonelPhorbin: posts small blind $1
iknewyouhadit: is sitting out
reynaldo1244: posts big blind $2
*** HOLE CARDS ***
iknewyouhadit leaves the table
bazman125: calls $2
rkinney64: calls $2
mrdust1: folds
dnagel222 joins the table at seat #1
ColonelPhorbin: calls $1
reynaldo1244: checks
*** FLOP *** [3s 2c 7d]
ColonelPhorbin: checks
reynaldo1244: checks
bazman125: bets $7.60
rkinney64: folds
ColonelPhorbin: folds
reynaldo1244: folds
Uncalled bet ($7.60) returned to bazman125
bazman125 collected $7.60 from pot
*** SUMMARY ***
Total pot $8 | Rake $0.40
Board [3s 2c 7d]
Seat 2: reynaldo1244 (big blind) folded on the Flop
Seat 3: bazman125 collected ($7.60)
Seat 4: rkinney64 folded on the Flop
Seat 5: mrdust1 (button) folded before Flop (didn't bet)
Seat 6: ColonelPhorbin (small blind) folded on the Flop


PokerStars Hand #232992823251:  Hold'em No Limit ($1/$2 USD) - 2022/01/16 12:54:29 ET
Table 'Atalante' 6-max Seat #6 is the button
Seat 2: reynaldo1244 ($203.45 in chips)
Seat 3: bazman125 ($89.72 in chips)
Seat 4: rkinney64 ($237.39 in chips)
Seat 5: mrdust1 ($200 in chips)
Seat 6: ColonelPhorbin ($133.80 in chips)
reynaldo1244: posts small blind $1
bazman125: posts big blind $2
*** HOLE CARDS ***
rkinney64: folds
mrdust1: raises $3 to $5
ColonelPhorbin: calls $5
reynaldo1244: folds
bazman125: calls $3
*** FLOP *** [2s 6c Js]
bazman125: checks
mrdust1: checks
ColonelPhorbin: bets $15.20
bazman125: folds
mrdust1: folds
Uncalled bet ($15.20) returned to ColonelPhorbin
ColonelPhorbin collected $15.20 from pot
*** SUMMARY ***
Total pot $16 | Rake $0.80
Board [2s 6c Js]
Seat 2: reynaldo1244 (small blind) folded before Flop
Seat 3: bazman125 (big blind) folded on the Flop
Seat 4: rkinney64 folded before Flop (didn't bet)
Seat 5: mrdust1 folded on the Flop
Seat 6: ColonelPhorbin (button) collected ($15.20)


PokerStars Hand #232992823481:  Hold'em No Limit ($1/$2 USD) - 2022/01/16 12:55:12 ET
Table 'Atalante' 6-max Seat #2 is the button
Seat 2: reynaldo1244 ($202.45 in chips)
Seat 3: bazman125 ($84.72 in chips)
Seat 4: rkinney64 ($237.39 in chips)
Seat 5: mrdust1 ($200 in chips)
Seat 6: ColonelPhorbin ($144 in chips)
bazman125: posts small blind $1
rkinney64: posts big blind $2
dnagel222: sits out
*** HOLE CARDS ***
mrdust1: folds
ColonelPhorbin: folds
reynaldo1244: folds
bazman125: calls $1
rkinney64: checks
*** FLOP *** [Ks 4d 9c]
bazman125: bets $2
rkinney64: calls $2
*** TURN *** [Ks 4d 9c] [Tc]
bazman125: bets $7.60
rkinney64: folds
Uncalled bet ($7.60) returned to bazman125
bazman125 collected $7.60 from pot
*** SUMMARY ***
Total pot $8 | Rake $0.40
Board [Ks 4d 9c Tc]
Seat 2: reynaldo1244 (button) folded before Flop (didn't bet)
Seat 3: bazman125 (small blind) collected ($7.60)
Seat 4: rkinney64 (big blind) folded on the Turn
Seat 5: mrdust1 folded before Flop (didn't bet)
Seat 6: ColonelPhorbin folded before Flop (didn't bet)


PokerStars Hand #232992823680:  Hold'em No Limit ($1/$2 USD) - 2022/01/16 12:55:55 ET
Table 'Atalante' 6-max Seat #3 is the button
Seat 2: reynaldo1244 ($202.45 in chips)
Seat 3: bazman125 ($88.32 in chips)
Seat 4: rkinney64 ($233.39 in chips)
Seat 5: mrdust1 ($200 in chips)
Seat 6: ColonelPhorbin ($144 in chips)
rkinney64: posts small blind $1
mrdust1: posts big blind $2
dnagel222: sits out
*** HOLE CARDS ***
ColonelPhorbin: raises $2 to $4
reynaldo1244: folds
bazman125: folds
rkinney64: folds
mrdust1: raises $16 to $20
ColonelPhorbin: calls $16
*** FLOP *** [7d 4s 8d]
mrdust1: bets $26.10
ColonelPhorbin: folds
Uncalled bet ($26.10) returned to mrdust1
mrdust1 collected $38.95 from pot
mrdust1: doesn't show hand
*** SUMMARY ***
Total pot $41 | Rake $2.05
Board [7d 4s 8d]
Seat 2: reynaldo1244 folded before Flop (didn't bet)
Seat 3: bazman125 (button) folded before Flop (didn't bet)
Seat 4: rkinney64 (small blind) folded before Flop
Seat 5: mrdust1 (big blind) collected ($38.95)
Seat 6: ColonelPhorbin folded on the Flop


PokerStars Hand #232992823942:  Hold'em No Limit ($1/$2 USD) - 2022/01/16 12:56:49 ET
Table 'Atalante' 6-max Seat #4 is the button
Seat 2: reynaldo1244 ($202.45 in chips)
Seat 3: bazman125 ($88.32 in chips)
Seat 4: rkinney64 ($232.39 in chips)
Seat 5: mrdust1 ($218.95 in chips)
Seat 6: ColonelPhorbin ($124 in chips)
mrdust1: posts small blind $1
ColonelPhorbin: posts big blind $2
dnagel222: sits out
*** HOLE CARDS ***
reynaldo1244: folds
bazman125: calls $2
rkinney64: calls $2
mrdust1: folds
ColonelPhorbin: raises $4 to $6
bazman125: calls $4
rkinney64: calls $4
*** FLOP *** [5s 2c 5d]
ColonelPhorbin: bets $18.05
bazman125: folds
rkinney64: folds
Uncalled bet ($18.05) returned to ColonelPhorbin
ColonelPhorbin collected $18.05 from pot
*** SUMMARY ***
Total pot $19 | Rake $0.95
Board [5s 2c 5d]
Seat 2: reynaldo1244 folded before Flop (didn't bet)
Seat 3: bazman125 folded on the Flop
Seat 4: rkinney64 (button) folded on the Flop
Seat 5: mrdust1 (small blind) folded before Flop
Seat 6: ColonelPhorbin (big blind) collected ($18.05)


PokerStars Hand #232992824146:  Hold'em No Limit ($1/$2 USD) - 2022/01/16 12:57:34 ET
Table 'Atalante' 6-max Seat #5 is the button
Seat 1: dnagel222 ($36.95 in chips)
Seat 2: reynaldo1244 ($202.45 in chips)
Seat 3: bazman125 ($82.32 in chips)
Seat 4: rkinney64 ($226.39 in chips)
Seat 5: mrdust1 ($217.95 in chips)
Seat 6: ColonelPhorbin ($136.05 in chips)
ColonelPhorbin: posts small blind $1
dnagel222: posts big blind $2
*** HOLE CARDS ***
reynaldo1244: folds
bazman125: folds
rkinney64: folds
mrdust1: folds
ColonelPhorbin: calls $1
dnagel222: checks
*** FLOP *** [Qh 8c 9c]
ColonelPhorbin: checks
dnagel222: checks
*** TURN *** [Qh 8c 9c] [6d]
ColonelPhorbin: bets $3.80
dnagel222: calls $3.80
*** RIVER *** [Qh 8c 9c 6d] [Ks]
ColonelPhorbin: bets $11.02
dnagel222: folds
Uncalled bet ($11.02) returned to ColonelPhorbin
ColonelPhorbin collected $11.02 from pot
*** SUMMARY ***
Total pot $11.60 | Rake $0.58
Board [Qh 8c 9c 6d Ks]
Seat 1: dnagel222 (big blind) folded on the River
Seat 2: reynaldo1244 folded before Flop (didn't bet)
Seat 3: bazman125 folded before Flop (didn't bet)
Seat 4: rkinney64 folded before Flop (didn't bet)
Seat 5: mrdust1 (button) folded before Flop (didn't bet)
Seat 6: ColonelPhorbin (small blind) collected ($11.02)


PokerStars Hand #232992824436:  Hold'em No Limit ($1/$2 USD) - 2022/01/16 12:58:32 ET
Table 'Atalante' 6-max Seat #6 is the button
Seat 1: dnagel222 ($31.15 in chips)
Seat 2: reynaldo1244 ($202.45 in chips)
Seat 3: bazman125 ($82.32 in chips)
Seat 4: rkinney64 ($226.39 in chips)
Seat 5: mrdust1 ($217.95 in chips)
Seat 6: ColonelPhorbin ($141.27 in chips)
dnagel222: posts small blind $1
reynaldo1244: posts big blind $2
*** HOLE CARDS ***
bazman125: calls $2
rkinney64: folds
mrdust1: folds
ColonelPhorbin: calls $2
dnagel222: calls $1
reynaldo1244: checks
*** FLOP *** [Qd Ad Ah]
dnagel222: bets $2
reynaldo1244: folds
bazman125: calls $2
ColonelPhorbin: folds
*** TURN *** [Qd Ad Ah] [Jc]
dnagel222: bets $2
bazman125: calls $2
*** RIVER *** [Qd Ad Ah Jc] [Kc]
dnagel222: bets $2
bazman125: calls $2
*** SHOW DOWN ***
dnagel222: shows [Qh 9s] (two pair, Aces and Queens)
bazman125: mucks hand
dnagel222 collected $19 from pot
*** SUMMARY ***
Total pot $20 | Rake $1
Board [Qd Ad Ah Jc Kc]
Seat 1: dnagel222 (small blind) showed [Qh 9s] and won ($19) with two pair, Aces and Queens
Seat 2: reynaldo1244 (big blind) folded on the Flop
Seat 3: bazman125 mucked
Seat 4: rkinney64 folded before Flop (didn't bet)
Seat 5: mrdust1 folded before Flop (didn't bet)
Seat 6: ColonelPhorbin (button) folded on the Flop


PokerStars Hand #232992824805:  Hold'em No Limit ($1/$2 USD) - 2022/01/16 12:59:53 ET
Table 'Atalante' 6-max Seat #1 is the button
Seat 1: dnagel222 ($42.15 in chips)
Seat 2: reynaldo1244 ($200.45 in chips)
Seat 3: bazman125 ($74.32 in chips)
Seat 4: rkinney64 ($226.39 in chips)
Seat 5: mrdust1 ($217.95 in chips)
Seat 6: ColonelPhorbin ($139.27 in chips)
reynaldo1244: posts small blind $1
bazman125: posts big blind $2
*** HOLE CARDS ***
rkinney64: folds
mrdust1: raises $3 to $5
ColonelPhorbin: folds
dnagel222: calls $5
reynaldo1244: folds
bazman125: calls $3
*** FLOP *** [2c 9h Qc]
bazman125: checks
mrdust1: checks
dnagel222: checks
*** TURN *** [2c 9h Qc] [4s]
bazman125: bets $15.20
mrdust1: calls $15.20
dnagel222: folds
*** RIVER *** [2c 9h Qc 4s] [2d]
bazman125: checks
mrdust1: checks
*** SHOW DOWN ***
bazman125: shows [8h Qh] (two pair, Queens and Deuces)
mrdust1: mucks hand
bazman125 collected $44.08 from pot
*** SUMMARY ***
Total pot $46.40 | Rake $2.32
Board [2c 9h Qc 4s 2d]
Seat 1: dnagel222 (button) folded on the Turn
Seat 2: reynaldo1244 (small blind) folded before Flop
Seat 3: bazman125 (big blind) showed [8h Qh] and won ($44.08) with two pair, Queens and Deuces
Seat 4: rkinney64 folded before Flop (didn't bet)
Seat 5: mrdust1 mucked
Seat 6: ColonelPhorbin folded before Flop (didn't bet)


PokerStars Hand #232992825124:  Hold'em No Limit ($1/$2 USD) - 2022/01/16 13:01:01 ET
Table 'Atalante' 6-max Seat #2 is the button
Seat 1: dnagel222 ($37.15 in chips)
Seat 2: reynaldo1244 ($200 in chips)
Seat 3: bazman125 ($98.20 in chips)
Seat 4: rkinney64 ($226.39 in chips)
Seat 5: mrdust1 ($200 in chips)
Seat 6: ColonelPhorbin ($139.27 in chips)
bazman125: posts small blind $1
rkinney64: posts big blind $2
*** HOLE CARDS ***
mrdust1: folds
ColonelPhorbin: calls $2
dnagel222: folds
reynaldo1244: calls $2
bazman125: calls $1
rkinney64: checks
*** FLOP *** [6d 3d As]
bazman125: checks
rkinney64: checks
ColonelPhorbin: checks
reynaldo1244: checks
*** TURN *** [6d 3d As] [Qc]
bazman125: checks
rkinney64: checks
ColonelPhorbin: checks
reynaldo1244: bets $3.80
bazman125: folds
rkinney64: calls $3.80
ColonelPhorbin: folds
*** RIVER *** [6d 3d As Qc] [7d]
rkinney64: bets $12
reynaldo1244: folds
Uncalled bet ($12) returned to rkinney64
rkinney64 collected $14.82 from pot
rkinney64: doesn't show hand
*** SUMMARY ***
Total pot $15.60 | Rake $0.78
Board [6d 3d As Qc 7d]
Seat 1: dnagel222 folded before Flop (didn't bet)
Seat 2: reynaldo1244 (button) folded on the River
Seat 3: bazman125 (small blind) folded on the Turn
Seat 4: rkinney64 (big blind) collected ($14.82)
Seat 5: mrdust1 folded before Flop (didn't bet)
Seat 6: ColonelPhorbin folded on the Turn


PokerStars Hand #232992825526:  Hold'em No Limit ($1/$2 USD) - 2022/01/16 13:02:15 ET
Table 'Atalante' 6-max Seat #3 is the button
Seat 1: dnagel222 ($37.15 in chips)
Seat 2: reynaldo1244 ($200 in chips)
Seat 3: bazman125 ($96.20 in chips)
Seat 4: rkinney64 ($235.41 in chips)
Seat 5: mrdust1 ($200 in chips)
Seat 6: ColonelPhorbin ($137.27 in chips)
rkinney64: posts small blind $1
mrdust1: posts big blind $2
*** HOLE CARDS ***
ColonelPhorbin: raises $2 to $4
dnagel222: calls $4
reynaldo1244: folds
bazman125: calls $4
rkinney64: calls $3
mrdust1: calls $2
*** FLOP *** [3d 8h 9d]
rkinney64: checks
mrdust1: checks
ColonelPhorbin: bets $9.50
dnagel222: raises $23.65 to $33.15 and is all-in
bazman125: folds
rkinney64: folds
mrdust1: folds
ColonelPhorbin: calls $23.65
*** TURN *** [3d 8h 9d] [Qd]
*** RIVER *** [3d 8h 9d Qd] [Ts]
*** SHOW DOWN ***
ColonelPhorbin: shows [9h 9c] (three of a kind, Nines)
dnagel222: shows [8c 9s] (two pair, Nines and Eights)
ColonelPhorbin collected $83.30 from pot
*** SUMMARY ***
Total pot $86.30 | Rake $3
Board [3d 8h 9d Qd Ts]
Seat 1: dnagel222 showed [8c 9s] and lost with two pair, Nines and Eights
Seat 2: reynaldo1244 folded before Flop (didn't bet)
Seat 3: bazman125 (button) folded on the Flop
Seat 4: rkinney64 (small blind) folded on the Flop
Seat 5: mrdust1 (big blind) folded on the Flop
Seat 6: ColonelPhorbin showed [9h 9c] and won ($83.30) with three of a kind, Nines


PokerStars Hand #232992825849:  Hold'em No Limit ($1/$2 USD) - 2022/01/16 13:03:17 ET
Table 'Atalante' 6-max Seat #4 is the button
Seat 2: reynaldo1244 ($200 in chips)
Seat 3: bazman125 ($92.20 in chips)
Seat 4: rkinney64 ($231.41 in chips)
Seat 5: mrdust1 ($200 in chips)
Seat 6: ColonelPhorbin ($183.42 in chips)
mrdust1: posts small blind $1
ColonelPhorbin: posts big blind $2
*** HOLE CARDS ***
reynaldo1244: folds
bazman125: folds
rkinney64: raises $4 to $6
mrdust1: folds
ColonelPhorbin: calls $4
*** FLOP *** [3h 6s Ah]
ColonelPhorbin: checks
rkinney64: bets $6
ColonelPhorbin: folds
Uncalled bet ($6) returned to rkinney64
rkinney64 collected $12.35 from pot
rkinney64: doesn't show hand
*** SUMMARY ***
Total pot $13 | Rake $0.65
Board [3h 6s Ah]
Seat 2: reynaldo1244 folded before Flop (didn't bet)
Seat 3: bazman125 folded before Flop (didn't bet)
Seat 4: rkinney64 (button) collected ($12.35)
Seat 5: mrdust1 (small blind) folded before Flop
Seat 6: ColonelPhorbin (big blind) folded on the Flop


PokerStars Hand #232992826015:  Hold'em No Limit ($1/$2 USD) - 2022/01/16 13:03:48 ET
Table 'Atalante' 6-max Seat #5 is the button
Seat 2: reynaldo1244 ($200 in chips)
Seat 3: bazman125 ($92.20 in chips)
Seat 4: rkinney64 ($237.76 in chips)
Seat 5: mrdust1 ($200 in chips)
Seat 6: ColonelPhorbin ($177.42 in chips)
ColonelPhorbin: posts small blind $1
reynaldo1244: posts big blind $2
*** HOLE CARDS ***
bazman125: folds
rkinney64: folds
mrdust1: folds
ColonelPhorbin: folds
Uncalled bet ($1) returned to reynaldo1244
reynaldo1244 collected $2 from pot
reynaldo1244: doesn't show hand
*** SUMMARY ***
Total pot $2 | Rake $0
Seat 2: reynaldo1244 (big blind) collected ($2)
Seat 3: bazman125 folded before Flop (didn't bet)
Seat 4: rkinney64 folded before Flop (didn't bet)
Seat 5: mrdust1 (button) folded before Flop (didn't bet)
Seat 6: ColonelPhorbin (small blind) folded before Flop


PokerStars Hand #232992826077:  Hold'em No Limit ($1/$2 USD) - 2022/01/16 13:03:57 ET
Table 'Atalante' 6-max Seat #6 is the button
Seat 2: reynaldo1244 ($201 in chips)
Seat 3: bazman125 ($92.20 in chips)
Seat 4: rkinney64 ($237.76 in chips)
Seat 5: mrdust1 ($200 in chips)
Seat 6: ColonelPhorbin ($176.42 in chips)
reynaldo1244: posts small blind $1
bazman125: posts big blind $2
*** HOLE CARDS ***
dnagel222 leaves the table
rkinney64: folds
MiltonBradley joins the table at seat #1
mrdust1: folds
ColonelPhorbin: raises $2 to $4
reynaldo1244: folds
bazman125: calls $2
*** FLOP *** [Ah 7c 9d]
bazman125: checks
ColonelPhorbin: checks
*** TURN *** [Ah 7c 9d] [9c]
bazman125: checks
ColonelPhorbin: bets $8.55
bazman125: calls $8.55
*** RIVER *** [Ah 7c 9d 9c] [5d]
bazman125: checks
ColonelPhorbin: checks
*** SHOW DOWN ***
bazman125: shows [Td 9s] (three of a kind, Nines)
ColonelPhorbin: mucks hand
bazman125 collected $24.80 from pot
*** SUMMARY ***
Total pot $26.10 | Rake $1.30
Board [Ah 7c 9d 9c 5d]
Seat 2: reynaldo1244 (small blind) folded before Flop
Seat 3: bazman125 (big blind) showed [Td 9s] and won ($24.80) with three of a kind, Nines
Seat 4: rkinney64 folded before Flop (didn't bet)
Seat 5: mrdust1 folded before Flop (didn't bet)
Seat 6: ColonelPhorbin (button) mucked


PokerStars Hand #232992826319:  Hold'em No Limit ($1/$2 USD) - 2022/01/16 13:04:42 ET
Table 'Atalante' 6-max Seat #2 is the button
Seat 2: reynaldo1244 ($200 in chips)
Seat 3: bazman125 ($104.45 in chips)
Seat 4: rkinney64 ($237.76 in chips)
Seat 5: mrdust1 ($200 in chips)
Seat 6: ColonelPhorbin ($163.87 in chips)
bazman125: posts small blind $1
rkinney64: posts big blind $2
MiltonBradley: sits out
*** HOLE CARDS ***
mrdust1: folds
ColonelPhorbin: raises $2 to $4
reynaldo1244: folds
bazman125: calls $3
rkinney64: calls $2
*** FLOP *** [Th 3c 6c]
bazman125: checks
rkinney64: checks
ColonelPhorbin: checks
*** TURN *** [Th 3c 6c] [7h]
bazman125: bets $2
rkinney64: calls $2
ColonelPhorbin: folds
*** RIVER *** [Th 3c 6c 7h] [5c]
bazman125: checks
rkinney64: bets $6
bazman125: folds
Uncalled bet ($6) returned to rkinney64
rkinney64 collected $15.20 from pot
rkinney64: doesn't show hand
*** SUMMARY ***
Total pot $16 | Rake $0.80
Board [Th 3c 6c 7h 5c]
Seat 2: reynaldo1244 (button) folded before Flop (didn't bet)
Seat 3: bazman125 (small blind) folded on the River
Seat 4: rkinney64 (big blind) collected ($15.20)
Seat 5: mrdust1 folded before Flop (didn't bet)
Seat 6: ColonelPhorbin folded on the Turn


PokerStars Hand #232992826619:  Hold'em No Limit ($1/$2 USD) - 2022/01/16 13:05:35 ET
Table 'Atalante' 6-max Seat #3 is the button
Seat 2: reynaldo1244 ($200 in chips)
Seat 3: bazman125 ($98.45 in chips)
Seat 4: rkinney64 ($246.96 in chips)
Seat 5: mrdust1 ($200 in chips)
Seat 6: ColonelPhorbin ($159.87 in chips)
rkinney64: posts small blind $1
mrdust1: posts big blind $2
MiltonBradley: sits out
*** HOLE CARDS ***
ColonelPhorbin: raises $4 to $6
reynaldo1244: folds
bazman125: folds
rkinney64: calls $5
mrdust1: folds
*** FLOP *** [4d 8c Kd]
rkinney64: checks
ColonelPhorbin: bets $6.65
rkinney64: folds
Uncalled bet ($6.65) returned to ColonelPhorbin
ColonelPhorbin collected $13.30 from pot
*** SUMMARY ***
Total pot $14 | Rake $0.70
Board [4d 8c Kd]
Seat 2: reynaldo1244 folded before Flop (didn't bet)
Seat 3: bazman125 (button) folded before Flop (didn't bet)
Seat 4: rkinney64 (small blind) folded on the Flop
Seat 5: mrdust1 (big blind) folded before Flop
Seat 6: ColonelPhorbin collected ($13.30)


PokerStars Hand #232992826779:  Hold'em No Limit ($1/$2 USD) - 2022/01/16 13:06:03 ET
Table 'Atalante' 6-max Seat #4 is the button
Seat 2: reynaldo1244 ($200 in chips)
Seat 3: bazman125 ($98.45 in chips)
Seat 4: rkinney64 ($240.96 in chips)
Seat 5: mrdust1 ($200 in chips)
Seat 6: ColonelPhorbin ($167.17 in chips)
mrdust1: posts small blind $1
ColonelPhorbin: posts big blind $2
MiltonBradley: sits out
*** HOLE CARDS ***
reynaldo1244: folds
bazman125: raises $2 to $4
rkinney64: calls $4
mrdust1: folds
ColonelPhorbin: calls $2
*** FLOP *** [Qd 7c As]
ColonelPhorbin: checks
bazman125: bets $6.18
rkinney64: calls $6.18
ColonelPhorbin: folds
*** TURN *** [Qd 7c As] [6c]
bazman125: bets $12.05
rkinney64: calls $12.05
*** RIVER *** [Qd 7c As 6c] [Jc]
bazman125: checks
rkinney64: bets $32
bazman125: calls $32
*** SHOW DOWN ***
rkinney64: shows [Qc Tc] (a flush, Queen high)
bazman125: mucks hand
rkinney64 collected $110.46 from pot
*** SUMMARY ***
Total pot $113.46 | Rake $3
Board [Qd 7c As 6c Jc]
Seat 2: reynaldo1244 folded before Flop (didn't bet)
Seat 3: bazman125 mucked
Seat 4: rkinney64 (button) showed [Qc Tc] and won ($110.46) with a flush, Queen high
Seat 5: mrdust1 (small blind) folded before Flop
Seat 6: ColonelPhorbin (big blind) folded on the Flop


PokerStars Hand #232992826965:  Hold'em No Limit ($1/$2 USD) - 2022/01/16 13:06:37 ET
Table 'Atalante' 6-max Seat #5 is the button
Seat 1: MiltonBradley ($308.39 in chips)
Seat 2: reynaldo1244 ($200 in chips)
Seat 3: bazman125 ($44.22 in chips)
Seat 4: rkinney64 ($297.19 in chips)
Seat 5: mrdust1 ($200 in chips)
Seat 6: ColonelPhorbin ($163.17 in chips)
ColonelPhorbin: posts small blind $1
MiltonBradley: posts big blind $2
*** HOLE CARDS ***
reynaldo1244: folds
bazman125: folds
rkinney64: folds
mrdust1: folds
ColonelPhorbin: folds
Uncalled bet ($1) returned to MiltonBradley
MiltonBradley collected $2 from pot
MiltonBradley: doesn't show hand
*** SUMMARY ***
Total pot $2 | Rake $0
Seat 1: MiltonBradley (big blind) collected ($2)
Seat 2: reynaldo1244 folded before Flop (didn't bet)
Seat 3: bazman125 folded before Flop (didn't bet)
Seat 4: rkinney64 folded before Flop (didn't bet)
Seat 5: mrdust1 (button) folded before Flop (didn't bet)
Seat 6: ColonelPhorbin (small blind) folded before Flop


PokerStars Hand #232992827080:  Hold'em No Limit ($1/$2 USD) - 2022/01/16 13:06:55 ET
Table 'Atalante' 6-max Seat #6 is the button
Seat 1: MiltonBradley ($309.39 in chips)
Seat 2: reynaldo1244 ($200 in chips)
Seat 3: bazman125 ($44.22 in chips)
Seat 4: rkinney64 ($297.19 in chips)
Seat 5: mrdust1 ($200 in chips)
Seat 6: ColonelPhorbin ($162.17 in chips)
MiltonBradley: posts small blind $1
reynaldo1244: posts big blind $2
*** HOLE CARDS ***
bazman125: folds
rkinney64: calls $2
mrdust1: raises $4.60 to $6.60
ColonelPhorbin: calls $6.60
MiltonBradley: folds
reynaldo1244: folds
rkinney64: folds
*** FLOP *** [Kc 2s Qh]
mrdust1: checks
ColonelPhorbin: bets $8.65
mrdust1: calls $8.65
*** TURN *** [Kc 2s Qh] [5h]
mrdust1: checks
ColonelPhorbin: checks
*** RIVER *** [Kc 2s Qh 5h] [4d]
mrdust1: checks
ColonelPhorbin: checks
*** SHOW DOWN ***
mrdust1: shows [Th Td] (a pair of Tens)
ColonelPhorbin: mucks hand
mrdust1 collected $33.72 from pot
*** SUMMARY ***
Total pot $35.50 | Rake $1.78
Board [Kc 2s Qh 5h 4d]
Seat 1: MiltonBradley (small blind) folded before Flop
Seat 2: reynaldo1244 (big blind) folded before Flop
Seat 3: bazman125 folded before Flop (didn't bet)
Seat 4: rkinney64 folded before Flop
Seat 5: mrdust1 showed [Th Td] and won ($33.72) with a pair of Tens
Seat 6: ColonelPhorbin (button) mucked


PokerStars Hand #232992827397:  Hold'em No Limit ($1/$2 USD) - 2022/01/16 13:07:53 ET
Table 'Atalante' 6-max Seat #1 is the button
Seat 1: MiltonBradley ($308.39 in chips)
Seat 2: reynaldo1244 ($200 in chips)
Seat 3: bazman125 ($44.22 in chips)
Seat 4: rkinney64 ($295.19 in chips)
Seat 5: mrdust1 ($218.47 in chips)
Seat 6: ColonelPhorbin ($146.92 in chips)
reynaldo1244: posts small blind $1
bazman125: posts big blind $2
*** HOLE CARDS ***
rkinney64: folds
mrdust1: folds
ColonelPhorbin: folds
MiltonBradley: raises $2.42 to $4.42
reynaldo1244: folds
bazman125: folds
Uncalled bet ($2.42) returned to MiltonBradley
MiltonBradley collected $5 from pot
MiltonBradley: doesn't show hand
*** SUMMARY ***
Total pot $5 | Rake $0
Seat 1: MiltonBradley (button) collected ($5)
Seat 2: reynaldo1244 (small blind) folded before Flop
Seat 3: bazman125 (big blind) folded before Flop
Seat 4: rkinney64 folded before Flop (didn't bet)
Seat 5: mrdust1 folded before Flop (didn't bet)
Seat 6: ColonelPhorbin folded before Flop (didn't bet)


PokerStars Hand #232992827535:  Hold'em No Limit ($1/$2 USD) - 2022/01/16 13:08:16 ET
Table 'Atalante' 6-max Seat #2 is the button
Seat 1: MiltonBradley ($311.39 in chips)
Seat 2: reynaldo1244 ($200 in chips)
Seat 3: bazman125 ($42.22 in chips)
Seat 4: rkinney64 ($295.19 in chips)
Seat 5: mrdust1 ($218.47 in chips)
Seat 6: ColonelPhorbin ($146.92 in chips)
bazman125: posts small blind $1
rkinney64: posts big blind $2
*** HOLE CARDS ***
mrdust1: raises $3 to $5
ColonelPhorbin: folds
MiltonBradley: folds
reynaldo1244: folds
bazman125: raises $9 to $14
rkinney64: folds
mrdust1: folds
Uncalled bet ($9) returned to bazman125
bazman125 collected $12 from pot
*** SUMMARY ***
Total pot $12 | Rake $0
Seat 1: MiltonBradley folded before Flop (didn't bet)
Seat 2: reynaldo1244 (button) folded before Flop (didn't bet)
Seat 3: bazman125 (small blind) collected ($12)
Seat 4: rkinney64 (big blind) folded before Flop
Seat 5: mrdust1 folded before Flop
Seat 6: ColonelPhorbin folded before Flop (didn't bet)


PokerStars Hand #232992827658:  Hold'em No Limit ($1/$2 USD) - 2022/01/16 13:08:39 ET
Table 'Atalante' 6-max Seat #3 is the button
Seat 1: MiltonBradley ($311.39 in chips)
Seat 2: reynaldo1244 ($200 in chips)
Seat 3: bazman125 ($49.22 in chips)
Seat 4: rkinney64 ($293.19 in chips)
Seat 5: mrdust1 ($213.47 in chips)
Seat 6: ColonelPhorbin ($146.92 in chips)
rkinney64: posts small blind $1
mrdust1: posts big blind $2
*** HOLE CARDS ***
ColonelPhorbin: folds
MiltonBradley: folds
reynaldo1244: folds
bazman125: folds
rkinney64: folds
Uncalled bet ($1) returned to mrdust1
mrdust1 collected $2 from pot
mrdust1: doesn't show hand
*** SUMMARY ***
Total pot $2 | Rake $0
Seat 1: MiltonBradley folded before Flop (didn't bet)
Seat 2: reynaldo1244 folded before Flop (didn't bet)
Seat 3: bazman125 (button) folded before Flop (didn't bet)
Seat 4: rkinney64 (small blind) folded before Flop
Seat 5: mrdust1 (big blind) collected ($2)
Seat 6: ColonelPhorbin folded before Flop (didn't bet)


PokerStars Hand #232992827719:  Hold'em No Limit ($1/$2 USD) - 2022/01/16 13:08:49 ET
Table 'Atalante' 6-max Seat #4 is the button
Seat 1: MiltonBradley ($311.39 in chips)
Seat 2: reynaldo1244 ($200 in chips)
Seat 3: bazman125 ($49.22 in chips)
Seat 4: rkinney64 ($292.19 in chips)
Seat 5: mrdust1 ($214.47 in chips)
Seat 6: ColonelPhorbin ($146.92 in chips)
mrdust1: posts small blind $1
ColonelPhorbin: posts big blind $2
*** HOLE CARDS ***
MiltonBradley: folds
reynaldo1244: folds
bazman125: raises $2 to $4
rkinney64: folds
mrdust1: folds
ColonelPhorbin: folds
Uncalled bet ($2) returned to bazman125
bazman125 collected $5 from pot
*** SUMMARY ***
Total pot $5 | Rake $0
Seat 1: MiltonBradley folded before Flop (didn't bet)
Seat 2: reynaldo1244 folded before Flop (didn't bet)
Seat 3: bazman125 collected ($5)
Seat 4: rkinney64 (button) folded before Flop (didn't bet)
Seat 5: mrdust1 (small blind) folded before Flop
Seat 6: ColonelPhorbin (big blind) folded before Flop


PokerStars Hand #232992827844:  Hold'em No Limit ($1/$2 USD) - 2022/01/16 13:09:14 ET
Table 'Atalante' 6-max Seat #5 is the button
Seat 1: MiltonBradley ($311.39 in chips)
Seat 2: reynaldo1244 ($200 in chips)
Seat 3: bazman125 ($52.22 in chips)
Seat 4: rkinney64 ($292.19 in chips)
Seat 5: mrdust1 ($213.47 in chips)
Seat 6: ColonelPhorbin ($144.92 in chips)
ColonelPhorbin: posts small blind $1
MiltonBradley: posts big blind $2
*** HOLE CARDS ***
reynaldo1244: folds
bazman125: folds
rkinney64: raises $4 to $6
mrdust1: folds
ColonelPhorbin: calls $5
MiltonBradley: folds
*** FLOP *** [7s Ad 2h]
ColonelPhorbin: checks
rkinney64: checks
*** TURN *** [7s Ad 2h] [Kd]
ColonelPhorbin: checks
rkinney64: checks
*** RIVER *** [7s Ad 2h Kd] [Jc]
ColonelPhorbin: bets $13.30
rkinney64: calls $13.30
*** SHOW DOWN ***
ColonelPhorbin: shows [2d Jd] (two pair, Jacks and Deuces)
rkinney64: mucks hand
ColonelPhorbin collected $38.57 from pot
*** SUMMARY ***
Total pot $40.60 | Rake $2.03
Board [7s Ad 2h Kd Jc]
Seat 1: MiltonBradley (big blind) folded before Flop
Seat 2: reynaldo1244 folded before Flop (didn't bet)
Seat 3: bazman125 folded before Flop (didn't bet)
Seat 4: rkinney64 mucked
Seat 5: mrdust1 (button) folded before Flop (didn't bet)
Seat 6: ColonelPhorbin (small blind) showed [2d Jd] and won ($38.57) with two pair, Jacks and Deuces


PokerStars Hand #232992828000:  Hold'em No Limit ($1/$2 USD) - 2022/01/16 13:09:45 ET
Table 'Atalante' 6-max Seat #6 is the button
Seat 1: MiltonBradley ($309.39 in chips)
Seat 2: reynaldo1244 ($200 in chips)
Seat 3: bazman125 ($52.22 in chips)
Seat 4: rkinney64 ($272.89 in chips)
Seat 5: mrdust1 ($213.47 in chips)
Seat 6: ColonelPhorbin ($164.19 in chips)
MiltonBradley: posts small blind $1
reynaldo1244: posts big blind $2
*** HOLE CARDS ***
bazman125: raises $2 to $4
rkinney64: folds
mrdust1: folds
ColonelPhorbin: folds
MiltonBradley: calls $3
reynaldo1244: calls $2
*** FLOP *** [2c Kd Js]
MiltonBradley: checks
reynaldo1244: checks
bazman125: bets $5.70
MiltonBradley: raises $7.75 to $13.45
reynaldo1244: folds
bazman125: raises $34.77 to $48.22 and is all-in
MiltonBradley: calls $34.77
*** TURN *** [2c Kd Js] [4c]
*** RIVER *** [2c Kd Js 4c] [Jc]
*** SHOW DOWN ***
MiltonBradley: shows [Ks Qd] (two pair, Kings and Jacks)
bazman125: shows [Ah Kh] (two pair, Kings and Jacks - Ace kicker)
bazman125 collected $105.44 from pot
*** SUMMARY ***
Total pot $108.44 | Rake $3
Board [2c Kd Js 4c Jc]
Seat 1: MiltonBradley (small blind) showed [Ks Qd] and lost with two pair, Kings and Jacks
Seat 2: reynaldo1244 (big blind) folded on the Flop
Seat 3: bazman125 showed [Ah Kh] and won ($105.44) with two pair, Kings and Jacks
Seat 4: rkinney64 folded before Flop (didn't bet)
Seat 5: mrdust1 folded before Flop (didn't bet)
Seat 6: ColonelPhorbin (button) folded before Flop (didn't bet)


PokerStars Hand #232992828281:  Hold'em No Limit ($1/$2 USD) - 2022/01/16 13:10:40 ET
Table 'Atalante' 6-max Seat #1 is the button
Seat 1: MiltonBradley ($257.17 in chips)
Seat 2: reynaldo1244 ($200 in chips)
Seat 3: bazman125 ($105.44 in chips)
Seat 4: rkinney64 ($272.89 in chips)
Seat 5: mrdust1 ($213.47 in chips)
Seat 6: ColonelPhorbin ($164.19 in chips)
reynaldo1244: posts small blind $1
bazman125: posts big blind $2
*** HOLE CARDS ***
rkinney64: calls $2
mrdust1: folds
ColonelPhorbin: folds
MiltonBradley: folds
reynaldo1244: folds
bazman125: checks
*** FLOP *** [Kh Tc 7c]
bazman125: bets $2
rkinney64: folds
Uncalled bet ($2) returned to bazman125
bazman125 collected $4.75 from pot
*** SUMMARY ***
Total pot $5 | Rake $0.25
Board [Kh Tc 7c]
Seat 1: MiltonBradley (button) folded before Flop (didn't bet)
Seat 2: reynaldo1244 (small blind) folded before Flop
Seat 3: bazman125 (big blind) collected ($4.75)
Seat 4: rkinney64 folded on the Flop
Seat 5: mrdust1 folded before Flop (didn't bet)
Seat 6: ColonelPhorbin folded before Flop (didn't bet)


PokerStars Hand #232992828409:  Hold'em No Limit ($1/$2 USD) - 2022/01/16 13:11:03 ET
Table 'Atalante' 6-max Seat #2 is the button
Seat 1: MiltonBradley ($257.17 in chips)
Seat 2: reynaldo1244 ($200 in chips)
Seat 3: bazman125 ($108.19 in chips)
Seat 4: rkinney64 ($270.89 in chips)
Seat 5: mrdust1 ($213.47 in chips)
Seat 6: ColonelPhorbin ($164.19 in chips)
bazman125: posts small blind $1
rkinney64: posts big blind $2
*** HOLE CARDS ***
mrdust1: folds
ColonelPhorbin: calls $2
MiltonBradley: folds
reynaldo1244: folds
bazman125: calls $1
rkinney64: checks
*** FLOP *** [9h 6s 2d]
bazman125: checks
rkinney64: checks
ColonelPhorbin: bets $5.70
bazman125: folds
rkinney64: folds
Uncalled bet ($5.70) returned to ColonelPhorbin
ColonelPhorbin collected $5.70 from pot
*** SUMMARY ***
Total pot $6 | Rake $0.30
Board [9h 6s 2d]
Seat 1: MiltonBradley folded before Flop (didn't bet)
Seat 2: reynaldo1244 (button) folded before Flop (didn't bet)
Seat 3: bazman125 (small blind) folded on the Flop
Seat 4: rkinney64 (big blind) folded on the Flop
Seat 5: mrdust1 folded before Flop (didn't bet)
Seat 6: ColonelPhorbin collected ($5.70)


PokerStars Hand #232992828610:  Hold'em No Limit ($1/$2 USD) - 2022/01/16 13:11:39 ET
Table 'Atalante' 6-max Seat #3 is the button
Seat 1: MiltonBradley ($257.17 in chips)
Seat 2: reynaldo1244 ($200 in chips)
Seat 3: bazman125 ($106.19 in chips)
Seat 4: rkinney64 ($268.89 in chips)
Seat 5: mrdust1 ($213.47 in chips)
Seat 6: ColonelPhorbin ($167.89 in chips)
rkinney64: posts small blind $1
mrdust1: posts big blind $2
*** HOLE CARDS ***
ColonelPhorbin: folds
MiltonBradley: raises $2.42 to $4.42
reynaldo1244: folds
bazman125: calls $4.42
rkinney64: folds
mrdust1: folds
*** FLOP *** [5s 3s 2s]
MiltonBradley: checks
bazman125: checks
*** TURN *** [5s 3s 2s] [As]
MiltonBradley: checks
bazman125: bets $2
MiltonBradley: folds
Uncalled bet ($2) returned to bazman125
bazman125 collected $11.25 from pot
*** SUMMARY ***
Total pot $11.84 | Rake $0.59
Board [5s 3s 2s As]
Seat 1: MiltonBradley folded on the Turn
Seat 2: reynaldo1244 folded before Flop (didn't bet)
Seat 3: bazman125 (button) collected ($11.25)
Seat 4: rkinney64 (small blind) folded before Flop
Seat 5: mrdust1 (big blind) folded before Flop
Seat 6: ColonelPhorbin folded before Flop (didn't bet)


PokerStars Hand #232992828823:  Hold'em No Limit ($1/$2 USD) - 2022/01/16 13:12:20 ET
Table 'Atalante' 6-max Seat #4 is the button
Seat 1: MiltonBradley ($252.75 in chips)
Seat 2: reynaldo1244 ($200 in chips)
Seat 3: bazman125 ($113.02 in chips)
Seat 4: rkinney64 ($267.89 in chips)
Seat 5: mrdust1 ($211.47 in chips)
Seat 6: ColonelPhorbin ($167.89 in chips)
mrdust1: posts small blind $1
ColonelPhorbin: posts big blind $2
*** HOLE CARDS ***
MiltonBradley: folds
reynaldo1244: folds
bazman125: folds
rkinney64: raises $6 to $8
mrdust1: folds
ColonelPhorbin: folds
Uncalled bet ($6) returned to rkinney64
rkinney64 collected $5 from pot
rkinney64: doesn't show hand
*** SUMMARY ***
Total pot $5 | Rake $0
Seat 1: MiltonBradley folded before Flop (didn't bet)
Seat 2: reynaldo1244 folded before Flop (didn't bet)
Seat 3: bazman125 folded before Flop (didn't bet)
Seat 4: rkinney64 (button) collected ($5)
Seat 5: mrdust1 (small blind) folded before Flop
Seat 6: ColonelPhorbin (big blind) folded before Flop


PokerStars Hand #232992828897:  Hold'em No Limit ($1/$2 USD) - 2022/01/16 13:12:33 ET
Table 'Atalante' 6-max Seat #5 is the button
Seat 1: MiltonBradley ($252.75 in chips)
Seat 2: reynaldo1244 ($200 in chips)
Seat 3: bazman125 ($113.02 in chips)
Seat 4: rkinney64 ($270.89 in chips)
Seat 5: mrdust1 ($210.47 in chips)
Seat 6: ColonelPhorbin ($165.89 in chips)
ColonelPhorbin: posts small blind $1
MiltonBradley: posts big blind $2
*** HOLE CARDS ***
reynaldo1244: folds
bazman125: folds
rkinney64: folds
mrdust1: folds
ColonelPhorbin: folds
Uncalled bet ($1) returned to MiltonBradley
MiltonBradley collected $2 from pot
MiltonBradley: doesn't show hand
*** SUMMARY ***
Total pot $2 | Rake $0
Seat 1: MiltonBradley (big blind) collected ($2)
Seat 2: reynaldo1244 folded before Flop (didn't bet)
Seat 3: bazman125 folded before Flop (didn't bet)
Seat 4: rkinney64 folded before Flop (didn't bet)
Seat 5: mrdust1 (button) folded before Flop (didn't bet)
Seat 6: ColonelPhorbin (small blind) folded before Flop


PokerStars Hand #232992828957:  Hold'em No Limit ($1/$2 USD) - 2022/01/16 13:12:43 ET
Table 'Atalante' 6-max Seat #6 is the button
Seat 1: MiltonBradley ($253.75 in chips)
Seat 2: reynaldo1244 ($200 in chips)
Seat 3: bazman125 ($113.02 in chips)
Seat 4: rkinney64 ($270.89 in chips)
Seat 5: mrdust1 ($210.47 in chips)
Seat 6: ColonelPhorbin ($164.89 in chips)
MiltonBradley: posts small blind $1
reynaldo1244: posts big blind $2
*** HOLE CARDS ***
bazman125: folds
rkinney64: folds
mrdust1: folds
ColonelPhorbin: raises $2 to $4
MiltonBradley: folds
reynaldo1244: calls $2
*** FLOP *** [Kh 7s 9h]
reynaldo1244: checks
ColonelPhorbin: bets $8.55
reynaldo1244: calls $8.55
*** TURN *** [Kh 7s 9h] [Qs]
reynaldo1244: checks
ColonelPhorbin: bets $12.40
reynaldo1244: calls $12.40
*** RIVER *** [Kh 7s 9h Qs] [As]
reynaldo1244: checks
ColonelPhorbin: checks
*** SHOW DOWN ***
reynaldo1244: shows [8d Ks] (a pair of Kings)
ColonelPhorbin: mucks hand
reynaldo1244 collected $48.36 from pot
*** SUMMARY ***
Total pot $50.90 | Rake $2.54
Board [Kh 7s 9h Qs As]
Seat 1: MiltonBradley (small blind) folded before Flop
Seat 2: reynaldo1244 (big blind) showed [8d Ks] and won ($48.36) with a pair of Kings
Seat 3: bazman125 folded before Flop (didn't bet)
Seat 4: rkinney64 folded before Flop (didn't bet)
Seat 5: mrdust1 folded before Flop (didn't bet)
Seat 6: ColonelPhorbin (button) mucked


PokerStars Hand #232992829214:  Hold'em No Limit ($1/$2 USD) - 2022/01/16 13:13:31 ET
Table 'Atalante' 6-max Seat #1 is the button
Seat 1: MiltonBradley ($252.75 in chips)
Seat 2: reynaldo1244 ($223.41 in chips)
Seat 3: bazman125 ($113.02 in chips)
Seat 4: rkinney64 ($270.89 in chips)
Seat 5: mrdust1 ($210.47 in chips)
Seat 6: ColonelPhorbin ($139.94 in chips)
reynaldo1244: posts small blind $1
bazman125: posts big blind $2
*** HOLE CARDS ***
rkinney64: folds
mrdust1: folds
ColonelPhorbin: folds
MiltonBradley: raises $2.42 to $4.42
reynaldo1244: folds
bazman125: calls $2.42
*** FLOP *** [3d 2s 6c]
bazman125: checks
MiltonBradley: checks
*** TURN *** [3d 2s 6c] [5s]
bazman125: bets $4.68
MiltonBradley: folds
Uncalled bet ($4.68) returned to bazman125
bazman125 collected $9.35 from pot
*** SUMMARY ***
Total pot $9.84 | Rake $0.49
Board [3d 2s 6c 5s]
Seat 1: MiltonBradley (button) folded on the Turn
Seat 2: reynaldo1244 (small blind) folded before Flop
Seat 3: bazman125 (big blind) collected ($9.35)
Seat 4: rkinney64 folded before Flop (didn't bet)
Seat 5: mrdust1 folded before Flop (didn't bet)
Seat 6: ColonelPhorbin folded before Flop (didn't bet)


PokerStars Hand #232992829387:  Hold'em No Limit ($1/$2 USD) - 2022/01/16 13:14:03 ET
Table 'Atalante' 6-max Seat #2 is the button
Seat 1: MiltonBradley ($248.33 in chips)
Seat 2: reynaldo1244 ($222.41 in chips)
Seat 3: bazman125 ($117.95 in chips)
Seat 4: rkinney64 ($270.89 in chips)
Seat 5: mrdust1 ($210.47 in chips)
Seat 6: ColonelPhorbin ($139.94 in chips)
bazman125: posts small blind $1
rkinney64: posts big blind $2
*** HOLE CARDS ***
mrdust1: folds
ColonelPhorbin: folds
MiltonBradley: folds
reynaldo1244: folds
bazman125: calls $1
rkinney64: raises $6 to $8
bazman125: folds
Uncalled bet ($6) returned to rkinney64
rkinney64 collected $4 from pot
rkinney64: doesn't show hand
*** SUMMARY ***
Total pot $4 | Rake $0
Seat 1: MiltonBradley folded before Flop (didn't bet)
Seat 2: reynaldo1244 (button) folded before Flop (didn't bet)
Seat 3: bazman125 (small blind) folded before Flop
Seat 4: rkinney64 (big blind) collected ($4)
Seat 5: mrdust1 folded before Flop (didn't bet)
Seat 6: ColonelPhorbin folded before Flop (didn't bet)


PokerStars Hand #232992829487:  Hold'em No Limit ($1/$2 USD) - 2022/01/16 13:14:24 ET
Table 'Atalante' 6-max Seat #3 is the button
Seat 1: MiltonBradley ($248.33 in chips)
Seat 2: reynaldo1244 ($222.41 in chips)
Seat 3: bazman125 ($115.95 in chips)
Seat 4: rkinney64 ($272.89 in chips)
Seat 5: mrdust1 ($210.47 in chips)
Seat 6: ColonelPhorbin ($139.94 in chips)
rkinney64: posts small blind $1
mrdust1: posts big blind $2
*** HOLE CARDS ***
ColonelPhorbin: folds
MiltonBradley: folds
reynaldo1244: folds
bazman125: folds
rkinney64: folds
Uncalled bet ($1) returned to mrdust1
mrdust1 collected $2 from pot
mrdust1: doesn't show hand
*** SUMMARY ***
Total pot $2 | Rake $0
Seat 1: MiltonBradley folded before Flop (didn't bet)
Seat 2: reynaldo1244 folded before Flop (didn't bet)
Seat 3: bazman125 (button) folded before Flop (didn't bet)
Seat 4: rkinney64 (small blind) folded before Flop
Seat 5: mrdust1 (big blind) collected ($2)
Seat 6: ColonelPhorbin folded before Flop (didn't bet)


PokerStars Hand #232992829576:  Hold'em No Limit ($1/$2 USD) - 2022/01/16 13:14:42 ET
Table 'Atalante' 6-max Seat #4 is the button
Seat 1: MiltonBradley ($248.33 in chips)
Seat 2: reynaldo1244 ($222.41 in chips)
Seat 3: bazman125 ($115.95 in chips)
Seat 4: rkinney64 ($271.89 in chips)
Seat 5: mrdust1 ($211.47 in chips)
Seat 6: ColonelPhorbin ($139.94 in chips)
mrdust1: posts small blind $1
ColonelPhorbin: posts big blind $2
*** HOLE CARDS ***
MiltonBradley: folds
reynaldo1244: raises $3 to $5
bazman125: folds
rkinney64: calls $5
mrdust1: folds
ColonelPhorbin: calls $3
*** FLOP *** [4d 9c Ks]
ColonelPhorbin: checks
reynaldo1244: bets $6
rkinney64: calls $6
ColonelPhorbin: calls $6
*** TURN *** [4d 9c Ks] [Ts]
ColonelPhorbin: bets $32.30
reynaldo1244: folds
rkinney64: folds
Uncalled bet ($32.30) returned to ColonelPhorbin
ColonelPhorbin collected $32.30 from pot
*** SUMMARY ***
Total pot $34 | Rake $1.70
Board [4d 9c Ks Ts]
Seat 1: MiltonBradley folded before Flop (didn't bet)
Seat 2: reynaldo1244 folded on the Turn
Seat 3: bazman125 folded before Flop (didn't bet)
Seat 4: rkinney64 (button) folded on the Turn
Seat 5: mrdust1 (small blind) folded before Flop
Seat 6: ColonelPhorbin (big blind) collected ($32.30)


PokerStars Hand #232992829784:  Hold'em No Limit ($1/$2 USD) - 2022/01/16 13:15:22 ET
Table 'Atalante' 6-max Seat #5 is the button
Seat 1: MiltonBradley ($248.33 in chips)
Seat 2: reynaldo1244 ($211.41 in chips)
Seat 3: bazman125 ($115.95 in chips)
Seat 4: rkinney64 ($260.89 in chips)
Seat 5: mrdust1 ($210.47 in chips)
Seat 6: ColonelPhorbin ($161.24 in chips)
ColonelPhorbin: posts small blind $1
MiltonBradley: posts big blind $2
*** HOLE CARDS ***
reynaldo1244: folds
bazman125: folds
rkinney64: folds
mrdust1: raises $3 to $5
ColonelPhorbin: calls $4
MiltonBradley: calls $3
*** FLOP *** [6s Ah 5s]
ColonelPhorbin: checks
MiltonBradley: checks
mrdust1: bets $4.70
ColonelPhorbin: calls $4.70
MiltonBradley: folds
*** TURN *** [6s Ah 5s] [4h]
ColonelPhorbin: checks
mrdust1: bets $17.62
ColonelPhorbin: calls $17.62
*** RIVER *** [6s Ah 5s 4h] [9c]
ColonelPhorbin: checks
mrdust1: checks
*** SHOW DOWN ***
ColonelPhorbin: shows [2d Ac] (a pair of Aces)
mrdust1: mucks hand
ColonelPhorbin collected $56.66 from pot
*** SUMMARY ***
Total pot $59.64 | Rake $2.98
Board [6s Ah 5s 4h 9c]
Seat 1: MiltonBradley (big blind) folded on the Flop
Seat 2: reynaldo1244 folded before Flop (didn't bet)
Seat 3: bazman125 folded before Flop (didn't bet)
Seat 4: rkinney64 folded before Flop (didn't bet)
Seat 5: mrdust1 (button) mucked
Seat 6: ColonelPhorbin (small blind) showed [2d Ac] and won ($56.66) with a pair of Aces


PokerStars Hand #232993021287:  Hold'em No Limit ($1/$2 USD) - 2022/01/16 13:16:28 ET
Table 'Atalante' 6-max Seat #6 is the button
Seat 1: MiltonBradley ($243.33 in chips)
Seat 2: reynaldo1244 ($211.41 in chips)
Seat 3: bazman125 ($115.95 in chips)
Seat 4: rkinney64 ($260.89 in chips)
Seat 5: mrdust1 ($200 in chips)
Seat 6: ColonelPhorbin ($190.58 in chips)
MiltonBradley: posts small blind $1
reynaldo1244: posts big blind $2
*** HOLE CARDS ***
bazman125: folds
rkinney64: folds
mrdust1: folds
ColonelPhorbin: raises $2 to $4
MiltonBradley: folds
reynaldo1244: folds
Uncalled bet ($2) returned to ColonelPhorbin
ColonelPhorbin collected $5 from pot
*** SUMMARY ***
Total pot $5 | Rake $0
Seat 1: MiltonBradley (small blind) folded before Flop
Seat 2: reynaldo1244 (big blind) folded before Flop
Seat 3: bazman125 folded before Flop (didn't bet)
Seat 4: rkinney64 folded before Flop (didn't bet)
Seat 5: mrdust1 folded before Flop (didn't bet)
Seat 6: ColonelPhorbin (button) collected ($5)


PokerStars Hand #232993021384:  Hold'em No Limit ($1/$2 USD) - 2022/01/16 13:16:47 ET
Table 'Atalante' 6-max Seat #1 is the button
Seat 1: MiltonBradley ($242.33 in chips)
Seat 2: reynaldo1244 ($209.41 in chips)
Seat 3: bazman125 ($115.95 in chips)
Seat 4: rkinney64 ($260.89 in chips)
Seat 5: mrdust1 ($200 in chips)
Seat 6: ColonelPhorbin ($193.58 in chips)
reynaldo1244: posts small blind $1
bazman125: posts big blind $2
*** HOLE CARDS ***
rkinney64: calls $2
mrdust1: folds
ColonelPhorbin: calls $2
MiltonBradley: folds
reynaldo1244: folds
bazman125: checks
*** FLOP *** [2d 7c Jd]
bazman125: checks
rkinney64: checks
ColonelPhorbin: bets $6.65
bazman125: calls $6.65
rkinney64: folds
*** TURN *** [2d 7c Jd] [6h]
bazman125: checks
ColonelPhorbin: bets $19.28
bazman125: calls $19.28
*** RIVER *** [2d 7c Jd 6h] [Tc]
bazman125: checks
ColonelPhorbin: bets $26
bazman125: calls $26
*** SHOW DOWN ***
ColonelPhorbin: shows [Ah 2h] (a pair of Deuces)
bazman125: shows [7d Td] (two pair, Tens and Sevens)
bazman125 collected $107.86 from pot
*** SUMMARY ***
Total pot $110.86 | Rake $3
Board [2d 7c Jd 6h Tc]
Seat 1: MiltonBradley (button) folded before Flop (didn't bet)
Seat 2: reynaldo1244 (small blind) folded before Flop
Seat 3: bazman125 (big blind) showed [7d Td] and won ($107.86) with two pair, Tens and Sevens
Seat 4: rkinney64 folded on the Flop
Seat 5: mrdust1 folded before Flop (didn't bet)
Seat 6: ColonelPhorbin showed [Ah 2h] and lost with a pair of Deuces


PokerStars Hand #232993021672:  Hold'em No Limit ($1/$2 USD) - 2022/01/16 13:17:52 ET
Table 'Atalante' 6-max Seat #2 is the button
Seat 1: MiltonBradley ($242.33 in chips)
Seat 2: reynaldo1244 ($208.41 in chips)
Seat 3: bazman125 ($169.88 in chips)
Seat 4: rkinney64 ($258.89 in chips)
Seat 5: mrdust1 ($200 in chips)
Seat 6: ColonelPhorbin ($139.65 in chips)
bazman125: posts small blind $1
rkinney64: posts big blind $2
*** HOLE CARDS ***
mrdust1: folds
ColonelPhorbin: folds
MiltonBradley: folds
reynaldo1244: raises $3 to $5
bazman125: folds
rkinney64: calls $3
*** FLOP *** [7c 2d 4d]
rkinney64: bets $6
reynaldo1244: calls $6
*** TURN *** [7c 2d 4d] [Qs]
rkinney64: checks
reynaldo1244: bets $10.93
rkinney64: folds
Uncalled bet ($10.93) returned to reynaldo1244
reynaldo1244 collected $21.85 from pot
reynaldo1244: doesn't show hand
*** SUMMARY ***
Total pot $23 | Rake $1.15
Board [7c 2d 4d Qs]
Seat 1: MiltonBradley folded before Flop (didn't bet)
Seat 2: reynaldo1244 (button) collected ($21.85)
Seat 3: bazman125 (small blind) folded before Flop
Seat 4: rkinney64 (big blind) folded on the Turn
Seat 5: mrdust1 folded before Flop (didn't bet)
Seat 6: ColonelPhorbin folded before Flop (didn't bet)


PokerStars Hand #232993021849:  Hold'em No Limit ($1/$2 USD) - 2022/01/16 13:18:27 ET
Table 'Atalante' 6-max Seat #3 is the button
Seat 1: MiltonBradley ($242.33 in chips)
Seat 2: reynaldo1244 ($219.26 in chips)
Seat 3: bazman125 ($168.88 in chips)
Seat 4: rkinney64 ($247.89 in chips)
Seat 5: mrdust1 ($200 in chips)
Seat 6: ColonelPhorbin ($139.65 in chips)
rkinney64: posts small blind $1
mrdust1: posts big blind $2
*** HOLE CARDS ***
ColonelPhorbin: raises $2 to $4
MiltonBradley: folds
reynaldo1244: folds
bazman125: folds
rkinney64: folds
mrdust1: folds
Uncalled bet ($2) returned to ColonelPhorbin
ColonelPhorbin collected $5 from pot
*** SUMMARY ***
Total pot $5 | Rake $0
Seat 1: MiltonBradley folded before Flop (didn't bet)
Seat 2: reynaldo1244 folded before Flop (didn't bet)
Seat 3: bazman125 (button) folded before Flop (didn't bet)
Seat 4: rkinney64 (small blind) folded before Flop
Seat 5: mrdust1 (big blind) folded before Flop
Seat 6: ColonelPhorbin collected ($5)


PokerStars Hand #232993021941:  Hold'em No Limit ($1/$2 USD) - 2022/01/16 13:18:48 ET
Table 'Atalante' 6-max Seat #4 is the button
Seat 1: MiltonBradley ($242.33 in chips)
Seat 2: reynaldo1244 ($219.26 in chips)
Seat 3: bazman125 ($168.88 in chips)
Seat 4: rkinney64 ($246.89 in chips)
Seat 5: mrdust1 ($200 in chips)
Seat 6: ColonelPhorbin ($142.65 in chips)
mrdust1: posts small blind $1
ColonelPhorbin: posts big blind $2
*** HOLE CARDS ***
MiltonBradley: folds
reynaldo1244: folds
bazman125: calls $2
rkinney64: calls $2
mrdust1: folds
ColonelPhorbin: checks
*** FLOP *** [Kc Jh 6s]
ColonelPhorbin: checks
bazman125: checks
rkinney64: checks
*** TURN *** [Kc Jh 6s] [2h]
ColonelPhorbin: bets $6.65
bazman125: calls $6.65
rkinney64: calls $6.65
*** RIVER *** [Kc Jh 6s 2h] [7c]
ColonelPhorbin: bets $25.60
bazman125: raises $25.60 to $51.20
rkinney64: folds
ColonelPhorbin: calls $25.60
*** SHOW DOWN ***
bazman125: shows [Kd Ks] (three of a kind, Kings)
ColonelPhorbin: mucks hand
bazman125 collected $126.35 from pot
*** SUMMARY ***
Total pot $129.35 | Rake $3
Board [Kc Jh 6s 2h 7c]
Seat 1: MiltonBradley folded before Flop (didn't bet)
Seat 2: reynaldo1244 folded before Flop (didn't bet)
Seat 3: bazman125 showed [Kd Ks] and won ($126.35) with three of a kind, Kings
Seat 4: rkinney64 (button) folded on the River
Seat 5: mrdust1 (small blind) folded before Flop
Seat 6: ColonelPhorbin (big blind) mucked


PokerStars Hand #232993022350:  Hold'em No Limit ($1/$2 USD) - 2022/01/16 13:20:10 ET
Table 'Atalante' 6-max Seat #5 is the button
Seat 1: MiltonBradley ($242.33 in chips)
Seat 2: reynaldo1244 ($219.26 in chips)
Seat 3: bazman125 ($235.38 in chips)
Seat 4: rkinney64 ($238.24 in chips)
Seat 5: mrdust1 ($200 in chips)
Seat 6: ColonelPhorbin ($82.80 in chips)
ColonelPhorbin: posts small blind $1
MiltonBradley: posts big blind $2
*** HOLE CARDS ***
reynaldo1244: folds
bazman125: calls $2
rkinney64: folds
mrdust1: raises $4.60 to $6.60
ColonelPhorbin: calls $5.60
MiltonBradley: folds
bazman125: calls $4.60
*** FLOP *** [Th Ac 9h]
ColonelPhorbin: checks
bazman125: checks
mrdust1: bets $6.83
ColonelPhorbin: calls $6.83
bazman125: folds
*** TURN *** [Th Ac 9h] [Tc]
ColonelPhorbin: checks
mrdust1: checks
*** RIVER *** [Th Ac 9h Tc] [6d]
ColonelPhorbin: bets $33.69
mrdust1: folds
Uncalled bet ($33.69) returned to ColonelPhorbin
ColonelPhorbin collected $33.69 from pot
*** SUMMARY ***
Total pot $35.46 | Rake $1.77
Board [Th Ac 9h Tc 6d]
Seat 1: MiltonBradley (big blind) folded before Flop
Seat 2: reynaldo1244 folded before Flop (didn't bet)
Seat 3: bazman125 folded on the Flop
Seat 4: rkinney64 folded before Flop (didn't bet)
Seat 5: mrdust1 (button) folded on the River
Seat 6: ColonelPhorbin (small blind) collected ($33.69)


PokerStars Hand #232993022696:  Hold'em No Limit ($1/$2 USD) - 2022/01/16 13:21:18 ET
Table 'Atalante' 6-max Seat #6 is the button
Seat 1: MiltonBradley ($240.33 in chips)
Seat 2: reynaldo1244 ($219.26 in chips)
Seat 3: bazman125 ($228.78 in chips)
Seat 4: rkinney64 ($238.24 in chips)
Seat 5: mrdust1 ($200 in chips)
Seat 6: ColonelPhorbin ($103.06 in chips)
MiltonBradley: posts small blind $1
reynaldo1244: posts big blind $2
*** HOLE CARDS ***
bazman125: folds
rkinney64: folds
mrdust1: raises $3 to $5
ColonelPhorbin: folds
MiltonBradley: folds
reynaldo1244: folds
Uncalled bet ($3) returned to mrdust1
mrdust1 collected $5 from pot
mrdust1: doesn't show hand
*** SUMMARY ***
Total pot $5 | Rake $0
Seat 1: MiltonBradley (small blind) folded before Flop
Seat 2: reynaldo1244 (big blind) folded before Flop
Seat 3: bazman125 folded before Flop (didn't bet)
Seat 4: rkinney64 folded before Flop (didn't bet)
Seat 5: mrdust1 collected ($5)
Seat 6: ColonelPhorbin (button) folded before Flop (didn't bet)


PokerStars Hand #232993022755:  Hold'em No Limit ($1/$2 USD) - 2022/01/16 13:21:29 ET
Table 'Atalante' 6-max Seat #1 is the button
Seat 1: MiltonBradley ($239.33 in chips)
Seat 2: reynaldo1244 ($217.26 in chips)
Seat 3: bazman125 ($228.78 in chips)
Seat 4: rkinney64 ($238.24 in chips)
Seat 5: mrdust1 ($203 in chips)
Seat 6: ColonelPhorbin ($103.06 in chips)
reynaldo1244: posts small blind $1
bazman125: posts big blind $2
*** HOLE CARDS ***
rkinney64: folds
mrdust1: folds
ColonelPhorbin: folds
MiltonBradley: raises $2.42 to $4.42
reynaldo1244: folds
bazman125: folds
Uncalled bet ($2.42) returned to MiltonBradley
MiltonBradley collected $5 from pot
MiltonBradley: doesn't show hand
*** SUMMARY ***
Total pot $5 | Rake $0
Seat 1: MiltonBradley (button) collected ($5)
Seat 2: reynaldo1244 (small blind) folded before Flop
Seat 3: bazman125 (big blind) folded before Flop
Seat 4: rkinney64 folded before Flop (didn't bet)
Seat 5: mrdust1 folded before Flop (didn't bet)
Seat 6: ColonelPhorbin folded before Flop (didn't bet)


PokerStars Hand #232993022873:  Hold'em No Limit ($1/$2 USD) - 2022/01/16 13:21:51 ET
Table 'Atalante' 6-max Seat #2 is the button
Seat 1: MiltonBradley ($242.33 in chips)
Seat 2: reynaldo1244 ($216.26 in chips)
Seat 3: bazman125 ($226.78 in chips)
Seat 4: rkinney64 ($238.24 in chips)
Seat 5: mrdust1 ($203 in chips)
Seat 6: ColonelPhorbin ($103.06 in chips)
bazman125: posts small blind $1
rkinney64: posts big blind $2
*** HOLE CARDS ***
mrdust1: folds
ColonelPhorbin: raises $2 to $4
MiltonBradley: folds
reynaldo1244: folds
bazman125: calls $3
rkinney64: folds
*** FLOP *** [Ts Jc 4h]
bazman125: checks
ColonelPhorbin: checks
*** TURN *** [Ts Jc 4h] [Ah]
bazman125: bets $4.75
ColonelPhorbin: calls $4.75
*** RIVER *** [Ts Jc 4h Ah] [9s]
bazman125: checks
ColonelPhorbin: checks
*** SHOW DOWN ***
bazman125: shows [5c 3c] (high card Ace)
ColonelPhorbin: shows [Qd Qc] (a pair of Queens)
ColonelPhorbin collected $18.52 from pot
*** SUMMARY ***
Total pot $19.50 | Rake $0.98
Board [Ts Jc 4h Ah 9s]
Seat 1: MiltonBradley folded before Flop (didn't bet)
Seat 2: reynaldo1244 (button) folded before Flop (didn't bet)
Seat 3: bazman125 (small blind) showed [5c 3c] and lost with high card Ace
Seat 4: rkinney64 (big blind) folded before Flop
Seat 5: mrdust1 folded before Flop (didn't bet)
Seat 6: ColonelPhorbin showed [Qd Qc] and won ($18.52) with a pair of Queens


PokerStars Hand #232993023167:  Hold'em No Limit ($1/$2 USD) - 2022/01/16 13:22:46 ET
Table 'Atalante' 6-max Seat #3 is the button
Seat 1: MiltonBradley ($242.33 in chips)
Seat 2: reynaldo1244 ($216.26 in chips)
Seat 3: bazman125 ($218.03 in chips)
Seat 4: rkinney64 ($236.24 in chips)
Seat 6: ColonelPhorbin ($112.83 in chips)
rkinney64: posts small blind $1
mrdust1: is sitting out
ColonelPhorbin: posts big blind $2
*** HOLE CARDS ***
MiltonBradley: folds
reynaldo1244: raises $3 to $5
bazman125: folds
rkinney64: folds
ColonelPhorbin: folds
Uncalled bet ($3) returned to reynaldo1244
reynaldo1244 collected $5 from pot
reynaldo1244: doesn't show hand
*** SUMMARY ***
Total pot $5 | Rake $0
Seat 1: MiltonBradley folded before Flop (didn't bet)
Seat 2: reynaldo1244 collected ($5)
Seat 3: bazman125 (button) folded before Flop (didn't bet)
Seat 4: rkinney64 (small blind) folded before Flop
Seat 6: ColonelPhorbin (big blind) folded before Flop


PokerStars Hand #232993023244:  Hold'em No Limit ($1/$2 USD) - 2022/01/16 13:22:59 ET
Table 'Atalante' 6-max Seat #4 is the button
Seat 1: MiltonBradley ($242.33 in chips)
Seat 2: reynaldo1244 ($219.26 in chips)
Seat 3: bazman125 ($218.03 in chips)
Seat 4: rkinney64 ($235.24 in chips)
Seat 6: ColonelPhorbin ($110.83 in chips)
ColonelPhorbin: posts small blind $1
MiltonBradley: posts big blind $2
*** HOLE CARDS ***
reynaldo1244: folds
bazman125: calls $2
rkinney64: folds
ColonelPhorbin: folds
reynaldo1244 leaves the table
MiltonBradley: checks
*** FLOP *** [7c Tc Jd]
MiltonBradley: checks
bazman125: bets $2
MiltonBradley: folds
Uncalled bet ($2) returned to bazman125
bazman125 collected $4.75 from pot
*** SUMMARY ***
Total pot $5 | Rake $0.25
Board [7c Tc Jd]
Seat 1: MiltonBradley (big blind) folded on the Flop
Seat 2: reynaldo1244 folded before Flop (didn't bet)
Seat 3: bazman125 collected ($4.75)
Seat 4: rkinney64 (button) folded before Flop (didn't bet)
Seat 6: ColonelPhorbin (small blind) folded before Flop


PokerStars Hand #232993023319:  Hold'em No Limit ($1/$2 USD) - 2022/01/16 13:23:13 ET
Table 'Atalante' 6-max Seat #6 is the button
Seat 1: MiltonBradley ($240.33 in chips)
Seat 3: bazman125 ($220.78 in chips)
Seat 4: rkinney64 ($235.24 in chips)
Seat 6: ColonelPhorbin ($109.83 in chips)
MiltonBradley: posts small blind $1
bazman125: posts big blind $2
*** HOLE CARDS ***
rkinney64: folds
ColonelPhorbin: folds
MiltonBradley: raises $4 to $6
bazman125: folds
Uncalled bet ($4) returned to MiltonBradley
MiltonBradley collected $4 from pot
MiltonBradley: doesn't show hand
*** SUMMARY ***
Total pot $4 | Rake $0
Seat 1: MiltonBradley (small blind) collected ($4)
Seat 3: bazman125 (big blind) folded before Flop
Seat 4: rkinney64 folded before Flop (didn't bet)
Seat 6: ColonelPhorbin (button) folded before Flop (didn't bet)


PokerStars Hand #232993023382:  Hold'em No Limit ($1/$2 USD) - 2022/01/16 13:23:26 ET
Table 'Atalante' 6-max Seat #1 is the button
Seat 1: MiltonBradley ($242.33 in chips)
Seat 3: bazman125 ($218.78 in chips)
Seat 4: rkinney64 ($235.24 in chips)
Seat 6: ColonelPhorbin ($109.83 in chips)
bazman125: posts small blind $1
rkinney64: posts big blind $2
*** HOLE CARDS ***
ColonelPhorbin: folds
MiltonBradley: folds
bazman125: calls $1
rkinney64: raises $6 to $8
bazman125: folds
Uncalled bet ($6) returned to rkinney64
rkinney64 collected $4 from pot
rkinney64: doesn't show hand
*** SUMMARY ***
Total pot $4 | Rake $0
Seat 1: MiltonBradley (button) folded before Flop (didn't bet)
Seat 3: bazman125 (small blind) folded before Flop
Seat 4: rkinney64 (big blind) collected ($4)
Seat 6: ColonelPhorbin folded before Flop (didn't bet)


PokerStars Hand #232993023456:  Hold'em No Limit ($1/$2 USD) - 2022/01/16 13:23:39 ET
Table 'Atalante' 6-max Seat #3 is the button
Seat 1: MiltonBradley ($242.33 in chips)
Seat 3: bazman125 ($216.78 in chips)
Seat 4: rkinney64 ($237.24 in chips)
Seat 6: ColonelPhorbin ($109.83 in chips)
rkinney64: posts small blind $1
ColonelPhorbin: posts big blind $2
*** HOLE CARDS ***
RAZOR99999 joins the table at seat #2
MiltonBradley: folds
bazman125: folds
rkinney64: folds
Uncalled bet ($1) returned to ColonelPhorbin
ColonelPhorbin collected $2 from pot
*** SUMMARY ***
Total pot $2 | Rake $0
Seat 1: MiltonBradley folded before Flop (didn't bet)
Seat 3: bazman125 (button) folded before Flop (didn't bet)
Seat 4: rkinney64 (small blind) folded before Flop
Seat 6: ColonelPhorbin (big blind) collected ($2)


PokerStars Hand #232993023500:  Hold'em No Limit ($1/$2 USD) - 2022/01/16 13:23:45 ET
Table 'Atalante' 6-max Seat #4 is the button
Seat 1: MiltonBradley ($242.33 in chips)
Seat 3: bazman125 ($216.78 in chips)
Seat 4: rkinney64 ($236.24 in chips)
Seat 6: ColonelPhorbin ($110.83 in chips)
ColonelPhorbin: posts small blind $1
MiltonBradley: posts big blind $2
RAZOR99999: sits out
*** HOLE CARDS ***
bazman125: folds
rkinney64: folds
ColonelPhorbin: raises $2 to $4
MiltonBradley: calls $2
*** FLOP *** [7s 5d 4h]
ColonelPhorbin: checks
MiltonBradley: bets $2.58
ColonelPhorbin: calls $2.58
*** TURN *** [7s 5d 4h] [9h]
ColonelPhorbin: checks
MiltonBradley: bets $9.75
ColonelPhorbin: folds
Uncalled bet ($9.75) returned to MiltonBradley
MiltonBradley collected $12.50 from pot
MiltonBradley: doesn't show hand
*** SUMMARY ***
Total pot $13.16 | Rake $0.66
Board [7s 5d 4h 9h]
Seat 1: MiltonBradley (big blind) collected ($12.50)
Seat 3: bazman125 folded before Flop (didn't bet)
Seat 4: rkinney64 (button) folded before Flop (didn't bet)
Seat 6: ColonelPhorbin (small blind) folded on the Turn


PokerStars Hand #232993023724:  Hold'em No Limit ($1/$2 USD) - 2022/01/16 13:24:26 ET
Table 'Atalante' 6-max Seat #6 is the button
Seat 1: MiltonBradley ($248.25 in chips)
Seat 2: RAZOR99999 ($80 in chips)
Seat 3: bazman125 ($216.78 in chips)
Seat 4: rkinney64 ($236.24 in chips)
Seat 6: ColonelPhorbin ($104.25 in chips)
MiltonBradley: posts small blind $1
RAZOR99999: posts big blind $2
*** HOLE CARDS ***
bazman125: folds
rkinney64: folds
ColonelPhorbin: calls $2
MiltonBradley: folds
RAZOR99999: raises $9 to $11
ColonelPhorbin: folds
Uncalled bet ($9) returned to RAZOR99999
RAZOR99999 collected $5 from pot
RAZOR99999: doesn't show hand
*** SUMMARY ***
Total pot $5 | Rake $0
Seat 1: MiltonBradley (small blind) folded before Flop
Seat 2: RAZOR99999 (big blind) collected ($5)
Seat 3: bazman125 folded before Flop (didn't bet)
Seat 4: rkinney64 folded before Flop (didn't bet)
Seat 6: ColonelPhorbin (button) folded before Flop


PokerStars Hand #232993023855:  Hold'em No Limit ($1/$2 USD) - 2022/01/16 13:24:48 ET
Table 'Atalante' 6-max Seat #1 is the button
Seat 1: MiltonBradley ($247.25 in chips)
Seat 2: RAZOR99999 ($83 in chips)
Seat 3: bazman125 ($216.78 in chips)
Seat 4: rkinney64 ($236.24 in chips)
Seat 6: ColonelPhorbin ($102.25 in chips)
RAZOR99999: posts small blind $1
bazman125: posts big blind $2
*** HOLE CARDS ***
rkinney64: folds
ColonelPhorbin: raises $2 to $4
MiltonBradley: folds
RAZOR99999: calls $3
bazman125: calls $2
*** FLOP *** [Ad Qh 9s]
RAZOR99999: checks
bazman125: checks
ColonelPhorbin: checks
*** TURN *** [Ad Qh 9s] [9d]
RAZOR99999: bets $12
bazman125: folds
ColonelPhorbin: calls $12
*** RIVER *** [Ad Qh 9s 9d] [Jh]
RAZOR99999: checks
ColonelPhorbin: bets $34.20
RAZOR99999: folds
Uncalled bet ($34.20) returned to ColonelPhorbin
ColonelPhorbin collected $34.20 from pot
*** SUMMARY ***
Total pot $36 | Rake $1.80
Board [Ad Qh 9s 9d Jh]
Seat 1: MiltonBradley (button) folded before Flop (didn't bet)
Seat 2: RAZOR99999 (small blind) folded on the River
Seat 3: bazman125 (big blind) folded on the Turn
Seat 4: rkinney64 folded before Flop (didn't bet)
Seat 6: ColonelPhorbin collected ($34.20)


PokerStars Hand #232993024206:  Hold'em No Limit ($1/$2 USD) - 2022/01/16 13:25:46 ET
Table 'Atalante' 6-max Seat #2 is the button
Seat 1: MiltonBradley ($247.25 in chips)
Seat 2: RAZOR99999 ($67 in chips)
Seat 3: bazman125 ($212.78 in chips)
Seat 4: rkinney64 ($236.24 in chips)
Seat 6: ColonelPhorbin ($120.45 in chips)
bazman125: posts small blind $1
rkinney64: posts big blind $2
mrdust1: sits out
*** HOLE CARDS ***
ColonelPhorbin: folds
MiltonBradley: raises $2.42 to $4.42
RAZOR99999: folds
bazman125: folds
rkinney64: folds
Uncalled bet ($2.42) returned to MiltonBradley
MiltonBradley collected $5 from pot
MiltonBradley: doesn't show hand
*** SUMMARY ***
Total pot $5 | Rake $0
Seat 1: MiltonBradley collected ($5)
Seat 2: RAZOR99999 (button) folded before Flop (didn't bet)
Seat 3: bazman125 (small blind) folded before Flop
Seat 4: rkinney64 (big blind) folded before Flop
Seat 6: ColonelPhorbin folded before Flop (didn't bet)


PokerStars Hand #232993024316:  Hold'em No Limit ($1/$2 USD) - 2022/01/16 13:26:04 ET
Table 'Atalante' 6-max Seat #3 is the button
Seat 1: MiltonBradley ($250.25 in chips)
Seat 2: RAZOR99999 ($67 in chips)
Seat 3: bazman125 ($211.78 in chips)
Seat 4: rkinney64 ($234.24 in chips)
Seat 5: mrdust1 ($203 in chips)
Seat 6: ColonelPhorbin ($120.45 in chips)
rkinney64: posts small blind $1
mrdust1: posts big blind $2
*** HOLE CARDS ***
ColonelPhorbin has timed out
ColonelPhorbin: folds
MiltonBradley: folds
RAZOR99999: folds
bazman125: calls $2
rkinney64: calls $1
mrdust1: checks
*** FLOP *** [5h Kh 3s]
rkinney64: bets $4
mrdust1: folds
bazman125: calls $4
*** TURN *** [5h Kh 3s] [9h]
rkinney64: bets $4
bazman125: folds
Uncalled bet ($4) returned to rkinney64
rkinney64 collected $13.30 from pot
rkinney64: doesn't show hand
*** SUMMARY ***
Total pot $14 | Rake $0.70
Board [5h Kh 3s 9h]
Seat 1: MiltonBradley folded before Flop (didn't bet)
Seat 2: RAZOR99999 folded before Flop (didn't bet)
Seat 3: bazman125 (button) folded on the Turn
Seat 4: rkinney64 (small blind) collected ($13.30)
Seat 5: mrdust1 (big blind) folded on the Flop
Seat 6: ColonelPhorbin folded before Flop (didn't bet)


PokerStars Hand #232993024670:  Hold'em No Limit ($1/$2 USD) - 2022/01/16 13:27:01 ET
Table 'Atalante' 6-max Seat #4 is the button
Seat 1: MiltonBradley ($250.25 in chips)
Seat 2: RAZOR99999 ($67 in chips)
Seat 3: bazman125 ($205.78 in chips)
Seat 4: rkinney64 ($241.54 in chips)
Seat 5: mrdust1 ($201 in chips)
Seat 6: ColonelPhorbin ($120.45 in chips)
mrdust1: posts small blind $1
ColonelPhorbin: posts big blind $2
*** HOLE CARDS ***
MiltonBradley: folds
RAZOR99999: folds
bazman125: raises $2 to $4
rkinney64: folds
mrdust1: raises $16 to $20
ColonelPhorbin: folds
bazman125: folds [Ac]
Uncalled bet ($16) returned to mrdust1
mrdust1 collected $10 from pot
mrdust1: doesn't show hand
*** SUMMARY ***
Total pot $10 | Rake $0
Seat 1: MiltonBradley folded before Flop (didn't bet)
Seat 2: RAZOR99999 folded before Flop (didn't bet)
Seat 3: bazman125 folded before Flop
Seat 4: rkinney64 (button) folded before Flop (didn't bet)
Seat 5: mrdust1 (small blind) collected ($10)
Seat 6: ColonelPhorbin (big blind) folded before Flop


PokerStars Hand #232993024848:  Hold'em No Limit ($1/$2 USD) - 2022/01/16 13:27:29 ET
Table 'Atalante' 6-max Seat #5 is the button
Seat 1: MiltonBradley ($250.25 in chips)
Seat 2: RAZOR99999 ($67 in chips)
Seat 3: bazman125 ($201.78 in chips)
Seat 4: rkinney64 ($241.54 in chips)
Seat 5: mrdust1 ($207 in chips)
Seat 6: ColonelPhorbin ($118.45 in chips)
ColonelPhorbin: posts small blind $1
MiltonBradley: posts big blind $2
*** HOLE CARDS ***
RAZOR99999: raises $4 to $6
bazman125: folds
rkinney64: folds
mrdust1: folds
ColonelPhorbin: folds
MiltonBradley: folds
Uncalled bet ($4) returned to RAZOR99999
RAZOR99999 collected $5 from pot
RAZOR99999: doesn't show hand
*** SUMMARY ***
Total pot $5 | Rake $0
Seat 1: MiltonBradley (big blind) folded before Flop
Seat 2: RAZOR99999 collected ($5)
Seat 3: bazman125 folded before Flop (didn't bet)
Seat 4: rkinney64 folded before Flop (didn't bet)
Seat 5: mrdust1 (button) folded before Flop (didn't bet)
Seat 6: ColonelPhorbin (small blind) folded before Flop


PokerStars Hand #232993024948:  Hold'em No Limit ($1/$2 USD) - 2022/01/16 13:27:44 ET
Table 'Atalante' 6-max Seat #6 is the button
Seat 1: MiltonBradley ($248.25 in chips)
Seat 2: RAZOR99999 ($70 in chips)
Seat 3: bazman125 ($201.78 in chips)
Seat 4: rkinney64 ($241.54 in chips)
Seat 5: mrdust1 ($207 in chips)
Seat 6: ColonelPhorbin ($117.45 in chips)
MiltonBradley: posts small blind $1
RAZOR99999: posts big blind $2
*** HOLE CARDS ***
bazman125: calls $2
rkinney64: folds
mrdust1: folds
ColonelPhorbin: raises $2 to $4
MiltonBradley: folds
RAZOR99999: folds
bazman125: raises $18 to $22
ColonelPhorbin: folds
Uncalled bet ($18) returned to bazman125
bazman125 collected $11 from pot
*** SUMMARY ***
Total pot $11 | Rake $0
Seat 1: MiltonBradley (small blind) folded before Flop
Seat 2: RAZOR99999 (big blind) folded before Flop
Seat 3: bazman125 collected ($11)
Seat 4: rkinney64 folded before Flop (didn't bet)
Seat 5: mrdust1 folded before Flop (didn't bet)
Seat 6: ColonelPhorbin (button) folded before Flop


PokerStars Hand #232993025125:  Hold'em No Limit ($1/$2 USD) - 2022/01/16 13:28:14 ET
Table 'Atalante' 6-max Seat #1 is the button
Seat 1: MiltonBradley ($247.25 in chips)
Seat 2: RAZOR99999 ($68 in chips)
Seat 3: bazman125 ($208.78 in chips)
Seat 4: rkinney64 ($241.54 in chips)
Seat 5: mrdust1 ($207 in chips)
Seat 6: ColonelPhorbin ($113.45 in chips)
RAZOR99999: posts small blind $1
bazman125: posts big blind $2
*** HOLE CARDS ***
rkinney64: folds
mrdust1: folds
ColonelPhorbin: folds
MiltonBradley: raises $2.42 to $4.42
RAZOR99999: folds
bazman125: calls $2.42
*** FLOP *** [Ks Kd 4h]
bazman125: checks
MiltonBradley: bets $2.99
bazman125: folds
Uncalled bet ($2.99) returned to MiltonBradley
MiltonBradley collected $9.35 from pot
MiltonBradley: doesn't show hand
*** SUMMARY ***
Total pot $9.84 | Rake $0.49
Board [Ks Kd 4h]
Seat 1: MiltonBradley (button) collected ($9.35)
Seat 2: RAZOR99999 (small blind) folded before Flop
Seat 3: bazman125 (big blind) folded on the Flop
Seat 4: rkinney64 folded before Flop (didn't bet)
Seat 5: mrdust1 folded before Flop (didn't bet)
Seat 6: ColonelPhorbin folded before Flop (didn't bet)


PokerStars Hand #232993025254:  Hold'em No Limit ($1/$2 USD) - 2022/01/16 13:28:36 ET
Table 'Atalante' 6-max Seat #2 is the button
Seat 1: MiltonBradley ($252.18 in chips)
Seat 2: RAZOR99999 ($67 in chips)
Seat 3: bazman125 ($204.36 in chips)
Seat 4: rkinney64 ($241.54 in chips)
Seat 5: mrdust1 ($207 in chips)
Seat 6: ColonelPhorbin ($113.45 in chips)
bazman125: posts small blind $1
rkinney64: posts big blind $2
*** HOLE CARDS ***
mrdust1: folds
ColonelPhorbin: folds
MiltonBradley: folds
RAZOR99999: raises $4 to $6
bazman125: folds
rkinney64: calls $4
*** FLOP *** [3s 6s Jh]
rkinney64: checks
RAZOR99999: bets $6
rkinney64: folds
Uncalled bet ($6) returned to RAZOR99999
RAZOR99999 collected $12.35 from pot
RAZOR99999: doesn't show hand
*** SUMMARY ***
Total pot $13 | Rake $0.65
Board [3s 6s Jh]
Seat 1: MiltonBradley folded before Flop (didn't bet)
Seat 2: RAZOR99999 (button) collected ($12.35)
Seat 3: bazman125 (small blind) folded before Flop
Seat 4: rkinney64 (big blind) folded on the Flop
Seat 5: mrdust1 folded before Flop (didn't bet)
Seat 6: ColonelPhorbin folded before Flop (didn't bet)


PokerStars Hand #232993025446:  Hold'em No Limit ($1/$2 USD) - 2022/01/16 13:29:08 ET
Table 'Atalante' 6-max Seat #3 is the button
Seat 1: MiltonBradley ($252.18 in chips)
Seat 2: RAZOR99999 ($73.35 in chips)
Seat 3: bazman125 ($203.36 in chips)
Seat 4: rkinney64 ($235.54 in chips)
Seat 5: mrdust1 ($207 in chips)
Seat 6: ColonelPhorbin ($113.45 in chips)
rkinney64: posts small blind $1
mrdust1: posts big blind $2
*** HOLE CARDS ***
ColonelPhorbin: raises $2 to $4
MiltonBradley: folds
RAZOR99999: folds
bazman125: calls $4
rkinney64: calls $3
mrdust1: folds
*** FLOP *** [5h As 2h]
rkinney64: bets $6
ColonelPhorbin: folds
bazman125: folds
Uncalled bet ($6) returned to rkinney64
rkinney64 collected $13.30 from pot
rkinney64: doesn't show hand
*** SUMMARY ***
Total pot $14 | Rake $0.70
Board [5h As 2h]
Seat 1: MiltonBradley folded before Flop (didn't bet)
Seat 2: RAZOR99999 folded before Flop (didn't bet)
Seat 3: bazman125 (button) folded on the Flop
Seat 4: rkinney64 (small blind) collected ($13.30)
Seat 5: mrdust1 (big blind) folded before Flop
Seat 6: ColonelPhorbin folded on the Flop


PokerStars Hand #232993025630:  Hold'em No Limit ($1/$2 USD) - 2022/01/16 13:29:39 ET
Table 'Atalante' 6-max Seat #4 is the button
Seat 1: MiltonBradley ($252.18 in chips)
Seat 2: RAZOR99999 ($73.35 in chips)
Seat 3: bazman125 ($199.36 in chips)
Seat 4: rkinney64 ($244.84 in chips)
Seat 5: mrdust1 ($205 in chips)
Seat 6: ColonelPhorbin ($109.45 in chips)
mrdust1: posts small blind $1
ColonelPhorbin: posts big blind $2
*** HOLE CARDS ***
MiltonBradley: raises $2.42 to $4.42
RAZOR99999: folds
bazman125: calls $4.42
rkinney64: folds
mrdust1: folds
ColonelPhorbin: folds
*** FLOP *** [6s Jh 8d]
MiltonBradley: checks
bazman125: checks
*** TURN *** [6s Jh 8d] [Jd]
MiltonBradley: checks
bazman125: bets $5.63
MiltonBradley: calls $5.63
*** RIVER *** [6s Jh 8d Jd] [2h]
MiltonBradley: checks
bazman125: checks
*** SHOW DOWN ***
MiltonBradley: shows [Ad Qs] (a pair of Jacks)
bazman125: shows [4d 4h] (two pair, Jacks and Fours)
bazman125 collected $21.94 from pot
*** SUMMARY ***
Total pot $23.10 | Rake $1.16
Board [6s Jh 8d Jd 2h]
Seat 1: MiltonBradley showed [Ad Qs] and lost with a pair of Jacks
Seat 2: RAZOR99999 folded before Flop (didn't bet)
Seat 3: bazman125 showed [4d 4h] and won ($21.94) with two pair, Jacks and Fours
Seat 4: rkinney64 (button) folded before Flop (didn't bet)
Seat 5: mrdust1 (small blind) folded before Flop
Seat 6: ColonelPhorbin (big blind) folded before Flop


PokerStars Hand #232993025852:  Hold'em No Limit ($1/$2 USD) - 2022/01/16 13:30:16 ET
Table 'Atalante' 6-max Seat #5 is the button
Seat 1: MiltonBradley ($242.13 in chips)
Seat 2: RAZOR99999 ($73.35 in chips)
Seat 3: bazman125 ($211.25 in chips)
Seat 4: rkinney64 ($244.84 in chips)
Seat 5: mrdust1 ($204 in chips)
Seat 6: ColonelPhorbin ($107.45 in chips)
ColonelPhorbin: posts small blind $1
MiltonBradley: posts big blind $2
*** HOLE CARDS ***
RAZOR99999: folds
bazman125: folds
rkinney64: folds
mrdust1: folds
ColonelPhorbin: folds
Uncalled bet ($1) returned to MiltonBradley
MiltonBradley collected $2 from pot
MiltonBradley: doesn't show hand
*** SUMMARY ***
Total pot $2 | Rake $0
Seat 1: MiltonBradley (big blind) collected ($2)
Seat 2: RAZOR99999 folded before Flop (didn't bet)
Seat 3: bazman125 folded before Flop (didn't bet)
Seat 4: rkinney64 folded before Flop (didn't bet)
Seat 5: mrdust1 (button) folded before Flop (didn't bet)
Seat 6: ColonelPhorbin (small blind) folded before Flop


PokerStars Hand #232993025917:  Hold'em No Limit ($1/$2 USD) - 2022/01/16 13:30:25 ET
Table 'Atalante' 6-max Seat #6 is the button
Seat 1: MiltonBradley ($243.13 in chips)
Seat 2: RAZOR99999 ($73.35 in chips)
Seat 3: bazman125 ($211.25 in chips)
Seat 4: rkinney64 ($244.84 in chips)
Seat 5: mrdust1 ($204 in chips)
Seat 6: ColonelPhorbin ($106.45 in chips)
MiltonBradley: posts small blind $1
RAZOR99999: posts big blind $2
*** HOLE CARDS ***
bazman125: folds
rkinney64: raises $4 to $6
mrdust1: folds
ColonelPhorbin: calls $6
MiltonBradley: folds
RAZOR99999: folds
*** FLOP *** [Kd Kh 6c]
rkinney64: checks
ColonelPhorbin: checks
*** TURN *** [Kd Kh 6c] [Qs]
rkinney64: checks
ColonelPhorbin: bets $14.25
rkinney64: folds
Uncalled bet ($14.25) returned to ColonelPhorbin
ColonelPhorbin collected $14.25 from pot
*** SUMMARY ***
Total pot $15 | Rake $0.75
Board [Kd Kh 6c Qs]
Seat 1: MiltonBradley (small blind) folded before Flop
Seat 2: RAZOR99999 (big blind) folded before Flop
Seat 3: bazman125 folded before Flop (didn't bet)
Seat 4: rkinney64 folded on the Turn
Seat 5: mrdust1 folded before Flop (didn't bet)
Seat 6: ColonelPhorbin (button) collected ($14.25)


PokerStars Hand #232993026080:  Hold'em No Limit ($1/$2 USD) - 2022/01/16 13:30:53 ET
Table 'Atalante' 6-max Seat #1 is the button
Seat 1: MiltonBradley ($242.13 in chips)
Seat 2: RAZOR99999 ($71.35 in chips)
Seat 3: bazman125 ($211.25 in chips)
Seat 4: rkinney64 ($238.84 in chips)
Seat 5: mrdust1 ($204 in chips)
Seat 6: ColonelPhorbin ($114.70 in chips)
RAZOR99999: posts small blind $1
bazman125: posts big blind $2
*** HOLE CARDS ***
rkinney64: folds
mrdust1: folds
ColonelPhorbin: folds
MiltonBradley: folds
RAZOR99999: folds
Uncalled bet ($1) returned to bazman125
bazman125 collected $2 from pot
*** SUMMARY ***
Total pot $2 | Rake $0
Seat 1: MiltonBradley (button) folded before Flop (didn't bet)
Seat 2: RAZOR99999 (small blind) folded before Flop
Seat 3: bazman125 (big blind) collected ($2)
Seat 4: rkinney64 folded before Flop (didn't bet)
Seat 5: mrdust1 folded before Flop (didn't bet)
Seat 6: ColonelPhorbin folded before Flop (didn't bet)


PokerStars Hand #232993026157:  Hold'em No Limit ($1/$2 USD) - 2022/01/16 13:31:06 ET
Table 'Atalante' 6-max Seat #2 is the button
Seat 1: MiltonBradley ($242.13 in chips)
Seat 2: RAZOR99999 ($70.35 in chips)
Seat 3: bazman125 ($212.25 in chips)
Seat 4: rkinney64 ($238.84 in chips)
Seat 5: mrdust1 ($204 in chips)
Seat 6: ColonelPhorbin ($114.70 in chips)
bazman125: posts small blind $1
rkinney64: posts big blind $2
*** HOLE CARDS ***
mrdust1: folds
ColonelPhorbin: raises $2 to $4
MiltonBradley: folds
RAZOR99999: folds
bazman125: calls $3
rkinney64: calls $2
*** FLOP *** [7s 3d 2s]
bazman125: checks
rkinney64: checks
ColonelPhorbin: checks
*** TURN *** [7s 3d 2s] [6d]
bazman125: checks
rkinney64: checks
ColonelPhorbin: checks
*** RIVER *** [7s 3d 2s 6d] [2c]
bazman125: checks
rkinney64: bets $12
ColonelPhorbin: calls $12
bazman125: folds
*** SHOW DOWN ***
rkinney64: shows [Kh Kd] (two pair, Kings and Deuces)
ColonelPhorbin: mucks hand
rkinney64 collected $34.20 from pot
*** SUMMARY ***
Total pot $36 | Rake $1.80
Board [7s 3d 2s 6d 2c]
Seat 1: MiltonBradley folded before Flop (didn't bet)
Seat 2: RAZOR99999 (button) folded before Flop (didn't bet)
Seat 3: bazman125 (small blind) folded on the River
Seat 4: rkinney64 (big blind) showed [Kh Kd] and won ($34.20) with two pair, Kings and Deuces
Seat 5: mrdust1 folded before Flop (didn't bet)
Seat 6: ColonelPhorbin mucked


PokerStars Hand #232993026532:  Hold'em No Limit ($1/$2 USD) - 2022/01/16 13:32:17 ET
Table 'Atalante' 6-max Seat #3 is the button
Seat 1: MiltonBradley ($242.13 in chips)
Seat 2: RAZOR99999 ($70.35 in chips)
Seat 3: bazman125 ($208.25 in chips)
Seat 4: rkinney64 ($257.04 in chips)
Seat 5: mrdust1 ($204 in chips)
Seat 6: ColonelPhorbin ($98.70 in chips)
rkinney64: posts small blind $1
mrdust1: posts big blind $2
*** HOLE CARDS ***
ColonelPhorbin: folds
MiltonBradley: folds
RAZOR99999: raises $5 to $7
bazman125: folds
rkinney64: folds
mrdust1: calls $5
*** FLOP *** [8s Th Jd]
mrdust1: checks
RAZOR99999: bets $6
mrdust1: folds
Uncalled bet ($6) returned to RAZOR99999
RAZOR99999 collected $14.25 from pot
RAZOR99999: doesn't show hand
*** SUMMARY ***
Total pot $15 | Rake $0.75
Board [8s Th Jd]
Seat 1: MiltonBradley folded before Flop (didn't bet)
Seat 2: RAZOR99999 collected ($14.25)
Seat 3: bazman125 (button) folded before Flop (didn't bet)
Seat 4: rkinney64 (small blind) folded before Flop
Seat 5: mrdust1 (big blind) folded on the Flop
Seat 6: ColonelPhorbin folded before Flop (didn't bet)


PokerStars Hand #232993026716:  Hold'em No Limit ($1/$2 USD) - 2022/01/16 13:32:52 ET
Table 'Atalante' 6-max Seat #4 is the button
Seat 1: MiltonBradley ($242.13 in chips)
Seat 2: RAZOR99999 ($77.60 in chips)
Seat 3: bazman125 ($208.25 in chips)
Seat 4: rkinney64 ($256.04 in chips)
Seat 5: mrdust1 ($200 in chips)
Seat 6: ColonelPhorbin ($98.70 in chips)
mrdust1: posts small blind $1
ColonelPhorbin: posts big blind $2
*** HOLE CARDS ***
MiltonBradley: raises $2 to $4
RAZOR99999: raises $11 to $15
bazman125: folds
rkinney64: folds
mrdust1: folds
ColonelPhorbin: folds
MiltonBradley: folds
Uncalled bet ($11) returned to RAZOR99999
RAZOR99999 collected $11 from pot
RAZOR99999: doesn't show hand
*** SUMMARY ***
Total pot $11 | Rake $0
Seat 1: MiltonBradley folded before Flop
Seat 2: RAZOR99999 collected ($11)
Seat 3: bazman125 folded before Flop (didn't bet)
Seat 4: rkinney64 (button) folded before Flop (didn't bet)
Seat 5: mrdust1 (small blind) folded before Flop
Seat 6: ColonelPhorbin (big blind) folded before Flop


PokerStars Hand #232993026898:  Hold'em No Limit ($1/$2 USD) - 2022/01/16 13:33:25 ET
Table 'Atalante' 6-max Seat #5 is the button
Seat 1: MiltonBradley ($238.13 in chips)
Seat 2: RAZOR99999 ($84.60 in chips)
Seat 3: bazman125 ($208.25 in chips)
Seat 4: rkinney64 ($256.04 in chips)
Seat 5: mrdust1 ($200 in chips)
Seat 6: ColonelPhorbin ($96.70 in chips)
ColonelPhorbin: posts small blind $1
MiltonBradley: posts big blind $2
*** HOLE CARDS ***
RAZOR99999: folds
bazman125 has timed out
bazman125: folds
rkinney64: raises $2 to $4
mrdust1: folds
ColonelPhorbin: calls $3
MiltonBradley: folds
*** FLOP *** [9s 8c Ad]
ColonelPhorbin: checks
rkinney64: checks
*** TURN *** [9s 8c Ad] [8s]
ColonelPhorbin: checks
rkinney64: checks
*** RIVER *** [9s 8c Ad 8s] [2h]
ColonelPhorbin: bets $9.50
rkinney64: folds
Uncalled bet ($9.50) returned to ColonelPhorbin
ColonelPhorbin collected $9.50 from pot
*** SUMMARY ***
Total pot $10 | Rake $0.50
Board [9s 8c Ad 8s 2h]
Seat 1: MiltonBradley (big blind) folded before Flop
Seat 2: RAZOR99999 folded before Flop (didn't bet)
Seat 3: bazman125 folded before Flop (didn't bet)
Seat 4: rkinney64 folded on the River
Seat 5: mrdust1 (button) folded before Flop (didn't bet)
Seat 6: ColonelPhorbin (small blind) collected ($9.50)


PokerStars Hand #232993027189:  Hold'em No Limit ($1/$2 USD) - 2022/01/16 13:34:19 ET
Table 'Atalante' 6-max Seat #6 is the button
Seat 1: MiltonBradley ($236.13 in chips)
Seat 2: RAZOR99999 ($84.60 in chips)
Seat 3: bazman125 ($208.25 in chips)
Seat 4: rkinney64 ($252.04 in chips)
Seat 5: mrdust1 ($200 in chips)
Seat 6: ColonelPhorbin ($102.20 in chips)
MiltonBradley: posts small blind $1
RAZOR99999: posts big blind $2
*** HOLE CARDS ***
bazman125: folds
rkinney64: folds
mrdust1: raises $3 to $5
ColonelPhorbin: calls $5
MiltonBradley: folds
RAZOR99999: folds
*** FLOP *** [3s 4d 8c]
mrdust1: bets $8.27
ColonelPhorbin: calls $8.27
*** TURN *** [3s 4d 8c] [Ts]
mrdust1: bets $21.33
ColonelPhorbin: folds
Uncalled bet ($21.33) returned to mrdust1
mrdust1 collected $28.06 from pot
mrdust1: doesn't show hand
*** SUMMARY ***
Total pot $29.54 | Rake $1.48
Board [3s 4d 8c Ts]
Seat 1: MiltonBradley (small blind) folded before Flop
Seat 2: RAZOR99999 (big blind) folded before Flop
Seat 3: bazman125 folded before Flop (didn't bet)
Seat 4: rkinney64 folded before Flop (didn't bet)
Seat 5: mrdust1 collected ($28.06)
Seat 6: ColonelPhorbin (button) folded on the Turn


PokerStars Hand #232993027381:  Hold'em No Limit ($1/$2 USD) - 2022/01/16 13:34:53 ET
Table 'Atalante' 6-max Seat #1 is the button
Seat 1: MiltonBradley ($235.13 in chips)
Seat 2: RAZOR99999 ($82.60 in chips)
Seat 3: bazman125 ($208.25 in chips)
Seat 4: rkinney64 ($252.04 in chips)
Seat 5: mrdust1 ($214.79 in chips)
Seat 6: ColonelPhorbin ($88.93 in chips)
RAZOR99999: posts small blind $1
bazman125: posts big blind $2
*** HOLE CARDS ***
rkinney64: raises $4 to $6
mrdust1: folds
ColonelPhorbin: folds
MiltonBradley: folds
RAZOR99999: folds
bazman125: folds
Uncalled bet ($4) returned to rkinney64
rkinney64 collected $5 from pot
rkinney64: doesn't show hand
*** SUMMARY ***
Total pot $5 | Rake $0
Seat 1: MiltonBradley (button) folded before Flop (didn't bet)
Seat 2: RAZOR99999 (small blind) folded before Flop
Seat 3: bazman125 (big blind) folded before Flop
Seat 4: rkinney64 collected ($5)
Seat 5: mrdust1 folded before Flop (didn't bet)
Seat 6: ColonelPhorbin folded before Flop (didn't bet)


PokerStars Hand #232993027505:  Hold'em No Limit ($1/$2 USD) - 2022/01/16 13:35:14 ET
Table 'Atalante' 6-max Seat #2 is the button
Seat 1: MiltonBradley ($235.13 in chips)
Seat 2: RAZOR99999 ($81.60 in chips)
Seat 3: bazman125 ($206.25 in chips)
Seat 4: rkinney64 ($255.04 in chips)
Seat 5: mrdust1 ($214.79 in chips)
Seat 6: ColonelPhorbin ($88.93 in chips)
bazman125: posts small blind $1
rkinney64: posts big blind $2
*** HOLE CARDS ***
mrdust1: folds
ColonelPhorbin: raises $2 to $4
MiltonBradley: folds
RAZOR99999: folds
bazman125: folds
rkinney64: calls $2
*** FLOP *** [Kh 3s Jc]
rkinney64: checks
ColonelPhorbin: checks
*** TURN *** [Kh 3s Jc] [8d]
rkinney64: bets $6
ColonelPhorbin: calls $6
*** RIVER *** [Kh 3s Jc 8d] [9h]
rkinney64: bets $6
ColonelPhorbin: calls $6
*** SHOW DOWN ***
rkinney64: shows [Js Ad] (a pair of Jacks)
ColonelPhorbin: shows [Kd Th] (a pair of Kings)
ColonelPhorbin collected $31.35 from pot
*** SUMMARY ***
Total pot $33 | Rake $1.65
Board [Kh 3s Jc 8d 9h]
Seat 1: MiltonBradley folded before Flop (didn't bet)
Seat 2: RAZOR99999 (button) folded before Flop (didn't bet)
Seat 3: bazman125 (small blind) folded before Flop
Seat 4: rkinney64 (big blind) showed [Js Ad] and lost with a pair of Jacks
Seat 5: mrdust1 folded before Flop (didn't bet)
Seat 6: ColonelPhorbin showed [Kd Th] and won ($31.35) with a pair of Kings


PokerStars Hand #232993027759:  Hold'em No Limit ($1/$2 USD) - 2022/01/16 13:35:57 ET
Table 'Atalante' 6-max Seat #3 is the button
Seat 1: MiltonBradley ($235.13 in chips)
Seat 2: RAZOR99999 ($81.60 in chips)
Seat 3: bazman125 ($205.25 in chips)
Seat 4: rkinney64 ($239.04 in chips)
Seat 5: mrdust1 ($214.79 in chips)
Seat 6: ColonelPhorbin ($104.28 in chips)
rkinney64: posts small blind $1
mrdust1: posts big blind $2
*** HOLE CARDS ***
ColonelPhorbin: raises $2 to $4
MiltonBradley: folds
RAZOR99999: folds
bazman125: calls $4
rkinney64: calls $3
mrdust1: folds
*** FLOP *** [6d 4h 8c]
rkinney64: checks
ColonelPhorbin: bets $13.30
bazman125: folds
rkinney64: folds
Uncalled bet ($13.30) returned to ColonelPhorbin
ColonelPhorbin collected $13.30 from pot
*** SUMMARY ***
Total pot $14 | Rake $0.70
Board [6d 4h 8c]
Seat 1: MiltonBradley folded before Flop (didn't bet)
Seat 2: RAZOR99999 folded before Flop (didn't bet)
Seat 3: bazman125 (button) folded on the Flop
Seat 4: rkinney64 (small blind) folded on the Flop
Seat 5: mrdust1 (big blind) folded before Flop
Seat 6: ColonelPhorbin collected ($13.30)


PokerStars Hand #232993028016:  Hold'em No Limit ($1/$2 USD) - 2022/01/16 13:36:38 ET
Table 'Atalante' 6-max Seat #4 is the button
Seat 1: MiltonBradley ($235.13 in chips)
Seat 2: RAZOR99999 ($81.60 in chips)
Seat 3: bazman125 ($201.25 in chips)
Seat 4: rkinney64 ($235.04 in chips)
Seat 5: mrdust1 ($212.79 in chips)
Seat 6: ColonelPhorbin ($113.58 in chips)
mrdust1: posts small blind $1
ColonelPhorbin: posts big blind $2
*** HOLE CARDS ***
MiltonBradley: folds
RAZOR99999: raises $5 to $7
bazman125: folds
rkinney64: folds
rkinney64 leaves the table
reynaldo1244 joins the table at seat #4
mrdust1: folds
ColonelPhorbin: calls $5
*** FLOP *** [4h Ah 5c]
ColonelPhorbin: checks
RAZOR99999: bets $7
ColonelPhorbin: folds
Uncalled bet ($7) returned to RAZOR99999
RAZOR99999 collected $14.25 from pot
RAZOR99999: doesn't show hand
*** SUMMARY ***
Total pot $15 | Rake $0.75
Board [4h Ah 5c]
Seat 1: MiltonBradley folded before Flop (didn't bet)
Seat 2: RAZOR99999 collected ($14.25)
Seat 3: bazman125 folded before Flop (didn't bet)
Seat 4: rkinney64 (button) folded before Flop (didn't bet)
Seat 5: mrdust1 (small blind) folded before Flop
Seat 6: ColonelPhorbin (big blind) folded on the Flop


PokerStars Hand #232993028241:  Hold'em No Limit ($1/$2 USD) - 2022/01/16 13:37:15 ET
Table 'Atalante' 6-max Seat #5 is the button
Seat 1: MiltonBradley ($235.13 in chips)
Seat 2: RAZOR99999 ($88.85 in chips)
Seat 3: bazman125 ($201.25 in chips)
Seat 5: mrdust1 ($211.79 in chips)
Seat 6: ColonelPhorbin ($106.58 in chips)
ColonelPhorbin: posts small blind $1
MiltonBradley: posts big blind $2
reynaldo1244: sits out
*** HOLE CARDS ***
RAZOR99999: folds
bazman125: raises $2 to $4
mrdust1: calls $4
ColonelPhorbin: folds
MiltonBradley: folds
*** FLOP *** [Ah 6d 7c]
bazman125: bets $2
mrdust1: raises $4.77 to $6.77
bazman125: calls $4.77
*** TURN *** [Ah 6d 7c] [5d]
bazman125: checks
mrdust1: bets $15.62
bazman125: folds
Uncalled bet ($15.62) returned to mrdust1
mrdust1 collected $23.31 from pot
mrdust1: doesn't show hand
*** SUMMARY ***
Total pot $24.54 | Rake $1.23
Board [Ah 6d 7c 5d]
Seat 1: MiltonBradley (big blind) folded before Flop
Seat 2: RAZOR99999 folded before Flop (didn't bet)
Seat 3: bazman125 folded on the Turn
Seat 5: mrdust1 (button) collected ($23.31)
Seat 6: ColonelPhorbin (small blind) folded before Flop


PokerStars Hand #232993028507:  Hold'em No Limit ($1/$2 USD) - 2022/01/16 13:37:57 ET
Table 'Atalante' 6-max Seat #6 is the button
Seat 1: MiltonBradley ($233.13 in chips)
Seat 2: RAZOR99999 ($88.85 in chips)
Seat 3: bazman125 ($190.48 in chips)
Seat 5: mrdust1 ($224.33 in chips)
Seat 6: ColonelPhorbin ($105.58 in chips)
MiltonBradley: posts small blind $1
RAZOR99999: posts big blind $2
reynaldo1244: sits out
*** HOLE CARDS ***
bazman125: folds
mrdust1: folds
ColonelPhorbin: raises $2 to $4
MiltonBradley: folds
RAZOR99999: calls $2
*** FLOP *** [7h 6c Js]
RAZOR99999: bets $6
ColonelPhorbin: calls $6
*** TURN *** [7h 6c Js] [3s]
RAZOR99999: checks
ColonelPhorbin: bets $19.95
RAZOR99999: folds
Uncalled bet ($19.95) returned to ColonelPhorbin
ColonelPhorbin collected $19.95 from pot
*** SUMMARY ***
Total pot $21 | Rake $1.05
Board [7h 6c Js 3s]
Seat 1: MiltonBradley (small blind) folded before Flop
Seat 2: RAZOR99999 (big blind) folded on the Turn
Seat 3: bazman125 folded before Flop (didn't bet)
Seat 5: mrdust1 folded before Flop (didn't bet)
Seat 6: ColonelPhorbin (button) collected ($19.95)


PokerStars Hand #232993028966:  Hold'em No Limit ($1/$2 USD) - 2022/01/16 13:39:08 ET
Table 'Atalante' 6-max Seat #1 is the button
Seat 1: MiltonBradley ($232.13 in chips)
Seat 2: RAZOR99999 ($78.85 in chips)
Seat 3: bazman125 ($190.48 in chips)
Seat 5: mrdust1 ($224.33 in chips)
Seat 6: ColonelPhorbin ($115.53 in chips)
RAZOR99999: posts small blind $1
bazman125: posts big blind $2
reynaldo1244: sits out
*** HOLE CARDS ***
mrdust1: raises $3 to $5
ColonelPhorbin: folds
MiltonBradley: folds
RAZOR99999: folds
bazman125: calls $3
*** FLOP *** [Jd 3h Ac]
bazman125: checks
mrdust1: bets $3.45
bazman125: calls $3.45
*** TURN *** [Jd 3h Ac] [7s]
bazman125: checks
mrdust1: bets $11.39
bazman125: folds
Uncalled bet ($11.39) returned to mrdust1
mrdust1 collected $17 from pot
mrdust1: doesn't show hand
*** SUMMARY ***
Total pot $17.90 | Rake $0.90
Board [Jd 3h Ac 7s]
Seat 1: MiltonBradley (button) folded before Flop (didn't bet)
Seat 2: RAZOR99999 (small blind) folded before Flop
Seat 3: bazman125 (big blind) folded on the Turn
Seat 5: mrdust1 collected ($17)
Seat 6: ColonelPhorbin folded before Flop (didn't bet)


PokerStars Hand #232993029369:  Hold'em No Limit ($1/$2 USD) - 2022/01/16 13:40:09 ET
Table 'Atalante' 6-max Seat #2 is the button
Seat 1: MiltonBradley ($232.13 in chips)
Seat 2: RAZOR99999 ($77.85 in chips)
Seat 3: bazman125 ($182.03 in chips)
Seat 4: reynaldo1244 ($219.26 in chips)
Seat 5: mrdust1 ($232.88 in chips)
Seat 6: ColonelPhorbin ($115.53 in chips)
bazman125: posts small blind $1
reynaldo1244: posts big blind $2
*** HOLE CARDS ***
mrdust1: folds
ColonelPhorbin: folds
MiltonBradley: folds
RAZOR99999: folds
bazman125: calls $1
reynaldo1244: checks
*** FLOP *** [Jh 3c Qc]
bazman125: bets $2
reynaldo1244: folds
Uncalled bet ($2) returned to bazman125
bazman125 collected $3.80 from pot
*** SUMMARY ***
Total pot $4 | Rake $0.20
Board [Jh 3c Qc]
Seat 1: MiltonBradley folded before Flop (didn't bet)
Seat 2: RAZOR99999 (button) folded before Flop (didn't bet)
Seat 3: bazman125 (small blind) collected ($3.80)
Seat 4: reynaldo1244 (big blind) folded on the Flop
Seat 5: mrdust1 folded before Flop (didn't bet)
Seat 6: ColonelPhorbin folded before Flop (didn't bet)


PokerStars Hand #232993029491:  Hold'em No Limit ($1/$2 USD) - 2022/01/16 13:40:29 ET
Table 'Atalante' 6-max Seat #3 is the button
Seat 1: MiltonBradley ($232.13 in chips)
Seat 2: RAZOR99999 ($77.85 in chips)
Seat 3: bazman125 ($183.83 in chips)
Seat 4: reynaldo1244 ($217.26 in chips)
Seat 5: mrdust1 ($232.88 in chips)
Seat 6: ColonelPhorbin ($115.53 in chips)
reynaldo1244: posts small blind $1
mrdust1: posts big blind $2
*** HOLE CARDS ***
ColonelPhorbin: raises $2 to $4
MiltonBradley: folds
RAZOR99999: folds
bazman125: folds
reynaldo1244: folds
mrdust1: folds
Uncalled bet ($2) returned to ColonelPhorbin
ColonelPhorbin collected $5 from pot
*** SUMMARY ***
Total pot $5 | Rake $0
Seat 1: MiltonBradley folded before Flop (didn't bet)
Seat 2: RAZOR99999 folded before Flop (didn't bet)
Seat 3: bazman125 (button) folded before Flop (didn't bet)
Seat 4: reynaldo1244 (small blind) folded before Flop
Seat 5: mrdust1 (big blind) folded before Flop
Seat 6: ColonelPhorbin collected ($5)


PokerStars Hand #232993029604:  Hold'em No Limit ($1/$2 USD) - 2022/01/16 13:40:47 ET
Table 'Atalante' 6-max Seat #4 is the button
Seat 1: MiltonBradley ($232.13 in chips)
Seat 2: RAZOR99999 ($77.85 in chips)
Seat 3: bazman125 ($183.83 in chips)
Seat 4: reynaldo1244 ($216.26 in chips)
Seat 5: mrdust1 ($230.88 in chips)
Seat 6: ColonelPhorbin ($118.53 in chips)
mrdust1: posts small blind $1
ColonelPhorbin: posts big blind $2
*** HOLE CARDS ***
MiltonBradley: raises $2.42 to $4.42
RAZOR99999: folds
bazman125: folds
reynaldo1244: raises $11.58 to $16
mrdust1: folds
ColonelPhorbin: calls $14
MiltonBradley: calls $11.58
*** FLOP *** [4h 5c 7h]
ColonelPhorbin: checks
MiltonBradley: checks
reynaldo1244: bets $31.03
ColonelPhorbin: folds
MiltonBradley: folds
Uncalled bet ($31.03) returned to reynaldo1244
reynaldo1244 collected $46.55 from pot
reynaldo1244: doesn't show hand
*** SUMMARY ***
Total pot $49 | Rake $2.45
Board [4h 5c 7h]
Seat 1: MiltonBradley folded on the Flop
Seat 2: RAZOR99999 folded before Flop (didn't bet)
Seat 3: bazman125 folded before Flop (didn't bet)
Seat 4: reynaldo1244 (button) collected ($46.55)
Seat 5: mrdust1 (small blind) folded before Flop
Seat 6: ColonelPhorbin (big blind) folded on the Flop


PokerStars Hand #232993029848:  Hold'em No Limit ($1/$2 USD) - 2022/01/16 13:41:28 ET
Table 'Atalante' 6-max Seat #5 is the button
Seat 1: MiltonBradley ($216.13 in chips)
Seat 2: RAZOR99999 ($77.85 in chips)
Seat 3: bazman125 ($183.83 in chips)
Seat 4: reynaldo1244 ($246.81 in chips)
Seat 5: mrdust1 ($229.88 in chips)
Seat 6: ColonelPhorbin ($102.53 in chips)
ColonelPhorbin: posts small blind $1
MiltonBradley: posts big blind $2
*** HOLE CARDS ***
RAZOR99999: folds
bazman125: folds
reynaldo1244: folds
mrdust1: raises $3 to $5
ColonelPhorbin: calls $4
MiltonBradley: calls $3
*** FLOP *** [2h Kh Kd]
ColonelPhorbin: checks
MiltonBradley: checks
mrdust1: bets $3.80
ColonelPhorbin: calls $3.80
MiltonBradley: folds
*** TURN *** [2h Kh Kd] [7h]
ColonelPhorbin: checks
mrdust1: bets $14.38
ColonelPhorbin: calls $14.38
*** RIVER *** [2h Kh Kd 7h] [9c]
ColonelPhorbin: bets $79.35 and is all-in
mrdust1: folds
Uncalled bet ($79.35) returned to ColonelPhorbin
ColonelPhorbin collected $48.79 from pot
*** SUMMARY ***
Total pot $51.36 | Rake $2.57
Board [2h Kh Kd 7h 9c]
Seat 1: MiltonBradley (big blind) folded on the Flop
Seat 2: RAZOR99999 folded before Flop (didn't bet)
Seat 3: bazman125 folded before Flop (didn't bet)
Seat 4: reynaldo1244 folded before Flop (didn't bet)
Seat 5: mrdust1 (button) folded on the River
Seat 6: ColonelPhorbin (small blind) collected ($48.79)


PokerStars Hand #232993276851:  Hold'em No Limit ($1/$2 USD) - 2022/01/16 13:42:35 ET
Table 'Atalante' 6-max Seat #6 is the button
Seat 1: MiltonBradley ($211.13 in chips)
Seat 2: RAZOR99999 ($77.85 in chips)
Seat 3: bazman125 ($183.83 in chips)
Seat 4: reynaldo1244 ($246.81 in chips)
Seat 5: mrdust1 ($206.70 in chips)
Seat 6: ColonelPhorbin ($128.14 in chips)
MiltonBradley: posts small blind $1
RAZOR99999: posts big blind $2
*** HOLE CARDS ***
bazman125: folds
reynaldo1244: folds
mrdust1: raises $3 to $5
ColonelPhorbin: calls $5
MiltonBradley: folds
RAZOR99999: folds
*** FLOP *** [5s Th 5h]
mrdust1: bets $4.08
ColonelPhorbin: calls $4.08
*** TURN *** [5s Th 5h] [Js]
mrdust1: bets $13.47
ColonelPhorbin: calls $13.47
*** RIVER *** [5s Th 5h Js] [9d]
mrdust1: bets $34.73
ColonelPhorbin: calls $34.73
*** SHOW DOWN ***
mrdust1: shows [Kd Jh] (two pair, Jacks and Fives)
ColonelPhorbin: mucks hand
mrdust1 collected $114.56 from pot
*** SUMMARY ***
Total pot $117.56 | Rake $3
Board [5s Th 5h Js 9d]
Seat 1: MiltonBradley (small blind) folded before Flop
Seat 2: RAZOR99999 (big blind) folded before Flop
Seat 3: bazman125 folded before Flop (didn't bet)
Seat 4: reynaldo1244 folded before Flop (didn't bet)
Seat 5: mrdust1 showed [Kd Jh] and won ($114.56) with two pair, Jacks and Fives
Seat 6: ColonelPhorbin (button) mucked


PokerStars Hand #232993277142:  Hold'em No Limit ($1/$2 USD) - 2022/01/16 13:43:24 ET
Table 'Atalante' 6-max Seat #1 is the button
Seat 1: MiltonBradley ($210.13 in chips)
Seat 2: RAZOR99999 ($75.85 in chips)
Seat 3: bazman125 ($183.83 in chips)
Seat 4: reynaldo1244 ($246.81 in chips)
Seat 5: mrdust1 ($263.98 in chips)
Seat 6: ColonelPhorbin ($70.86 in chips)
RAZOR99999: posts small blind $1
bazman125: posts big blind $2
*** HOLE CARDS ***
reynaldo1244: folds
mrdust1: folds
ColonelPhorbin: calls $2
MiltonBradley: raises $7 to $9
RAZOR99999: folds
bazman125: folds
ColonelPhorbin: calls $7
*** FLOP *** [Js 5h 6c]
ColonelPhorbin: checks
MiltonBradley: checks
*** TURN *** [Js 5h 6c] [8s]
ColonelPhorbin: checks
MiltonBradley: checks
*** RIVER *** [Js 5h 6c 8s] [Kd]
ColonelPhorbin: bets $9.98
MiltonBradley: folds
Uncalled bet ($9.98) returned to ColonelPhorbin
ColonelPhorbin collected $19.95 from pot
*** SUMMARY ***
Total pot $21 | Rake $1.05
Board [Js 5h 6c 8s Kd]
Seat 1: MiltonBradley (button) folded on the River
Seat 2: RAZOR99999 (small blind) folded before Flop
Seat 3: bazman125 (big blind) folded before Flop
Seat 4: reynaldo1244 folded before Flop (didn't bet)
Seat 5: mrdust1 folded before Flop (didn't bet)
Seat 6: ColonelPhorbin collected ($19.95)


PokerStars Hand #232993277375:  Hold'em No Limit ($1/$2 USD) - 2022/01/16 13:44:05 ET
Table 'Atalante' 6-max Seat #2 is the button
Seat 1: MiltonBradley ($201.13 in chips)
Seat 2: RAZOR99999 ($74.85 in chips)
Seat 3: bazman125 ($181.83 in chips)
Seat 4: reynaldo1244 ($246.81 in chips)
Seat 5: mrdust1 ($263.98 in chips)
Seat 6: ColonelPhorbin ($81.81 in chips)
bazman125: posts small blind $1
reynaldo1244: posts big blind $2
*** HOLE CARDS ***
mrdust1: folds
ColonelPhorbin: calls $2
MiltonBradley: folds
RAZOR99999: folds
bazman125: calls $1
reynaldo1244: checks
*** FLOP *** [Qs 5c 8c]
bazman125: bets $2
reynaldo1244: calls $2
ColonelPhorbin: folds
*** TURN *** [Qs 5c 8c] [6h]
bazman125: bets $2
reynaldo1244: raises $8 to $10
bazman125: folds [Qc]
Uncalled bet ($8) returned to reynaldo1244
reynaldo1244 collected $13.30 from pot
reynaldo1244: doesn't show hand
*** SUMMARY ***
Total pot $14 | Rake $0.70
Board [Qs 5c 8c 6h]
Seat 1: MiltonBradley folded before Flop (didn't bet)
Seat 2: RAZOR99999 (button) folded before Flop (didn't bet)
Seat 3: bazman125 (small blind) folded on the Turn
Seat 4: reynaldo1244 (big blind) collected ($13.30)
Seat 5: mrdust1 folded before Flop (didn't bet)
Seat 6: ColonelPhorbin folded on the Flop


PokerStars Hand #232993277627:  Hold'em No Limit ($1/$2 USD) - 2022/01/16 13:44:51 ET
Table 'Atalante' 6-max Seat #3 is the button
Seat 1: MiltonBradley ($201.13 in chips)
Seat 2: RAZOR99999 ($74.85 in chips)
Seat 3: bazman125 ($175.83 in chips)
Seat 4: reynaldo1244 ($254.11 in chips)
Seat 5: mrdust1 ($263.98 in chips)
Seat 6: ColonelPhorbin ($79.81 in chips)
reynaldo1244: posts small blind $1
mrdust1: posts big blind $2
*** HOLE CARDS ***
ColonelPhorbin: raises $2 to $4
MiltonBradley: folds
RAZOR99999: calls $4
bazman125: calls $4
reynaldo1244: raises $18 to $22
mrdust1: folds
ColonelPhorbin: folds
RAZOR99999: folds
bazman125: calls $18
*** FLOP *** [Ts 9d Ah]
reynaldo1244: bets $18
bazman125: raises $135.83 to $153.83 and is all-in
reynaldo1244: folds
Uncalled bet ($135.83) returned to bazman125
bazman125 collected $87 from pot
*** SUMMARY ***
Total pot $90 | Rake $3
Board [Ts 9d Ah]
Seat 1: MiltonBradley folded before Flop (didn't bet)
Seat 2: RAZOR99999 folded before Flop
Seat 3: bazman125 (button) collected ($87)
Seat 4: reynaldo1244 (small blind) folded on the Flop
Seat 5: mrdust1 (big blind) folded before Flop
Seat 6: ColonelPhorbin folded before Flop


PokerStars Hand #232993277886:  Hold'em No Limit ($1/$2 USD) - 2022/01/16 13:45:36 ET
Table 'Atalante' 6-max Seat #4 is the button
Seat 1: MiltonBradley ($201.13 in chips)
Seat 2: RAZOR99999 ($70.85 in chips)
Seat 3: bazman125 ($222.83 in chips)
Seat 4: reynaldo1244 ($214.11 in chips)
Seat 5: mrdust1 ($261.98 in chips)
Seat 6: ColonelPhorbin ($75.81 in chips)
mrdust1: posts small blind $1
ColonelPhorbin: posts big blind $2
*** HOLE CARDS ***
MiltonBradley: folds
RAZOR99999: folds
bazman125: folds
reynaldo1244: raises $3 to $5
mrdust1: folds
ColonelPhorbin: folds
Uncalled bet ($3) returned to reynaldo1244
reynaldo1244 collected $5 from pot
reynaldo1244: doesn't show hand
*** SUMMARY ***
Total pot $5 | Rake $0
Seat 1: MiltonBradley folded before Flop (didn't bet)
Seat 2: RAZOR99999 folded before Flop (didn't bet)
Seat 3: bazman125 folded before Flop (didn't bet)
Seat 4: reynaldo1244 (button) collected ($5)
Seat 5: mrdust1 (small blind) folded before Flop
Seat 6: ColonelPhorbin (big blind) folded before Flop


PokerStars Hand #232993277956:  Hold'em No Limit ($1/$2 USD) - 2022/01/16 13:45:48 ET
Table 'Atalante' 6-max Seat #5 is the button
Seat 1: MiltonBradley ($201.13 in chips)
Seat 2: RAZOR99999 ($70.85 in chips)
Seat 3: bazman125 ($222.83 in chips)
Seat 4: reynaldo1244 ($217.11 in chips)
Seat 5: mrdust1 ($260.98 in chips)
Seat 6: ColonelPhorbin ($73.81 in chips)
ColonelPhorbin: posts small blind $1
MiltonBradley: posts big blind $2
*** HOLE CARDS ***
RAZOR99999: folds
bazman125: raises $2 to $4
reynaldo1244: calls $4
mrdust1: folds
ColonelPhorbin: calls $3
MiltonBradley: folds
*** FLOP *** [Qs 2c 9s]
ColonelPhorbin: checks
bazman125: bets $2
reynaldo1244: calls $2
ColonelPhorbin: calls $2
*** TURN *** [Qs 2c 9s] [3c]
ColonelPhorbin: checks
bazman125: checks
reynaldo1244: checks
*** RIVER *** [Qs 2c 9s 3c] [4c]
ColonelPhorbin: bets $19
bazman125: folds
reynaldo1244: raises $192.11 to $211.11 and is all-in
ColonelPhorbin: folds
Uncalled bet ($192.11) returned to reynaldo1244
reynaldo1244 collected $55.10 from pot
reynaldo1244: doesn't show hand
*** SUMMARY ***
Total pot $58 | Rake $2.90
Board [Qs 2c 9s 3c 4c]
Seat 1: MiltonBradley (big blind) folded before Flop
Seat 2: RAZOR99999 folded before Flop (didn't bet)
Seat 3: bazman125 folded on the River
Seat 4: reynaldo1244 collected ($55.10)
Seat 5: mrdust1 (button) folded before Flop (didn't bet)
Seat 6: ColonelPhorbin (small blind) folded on the River


PokerStars Hand #232993278252:  Hold'em No Limit ($1/$2 USD) - 2022/01/16 13:46:37 ET
Table 'Atalante' 6-max Seat #6 is the button
Seat 1: MiltonBradley ($200 in chips)
Seat 2: RAZOR99999 ($70.85 in chips)
Seat 3: bazman125 ($216.83 in chips)
Seat 4: reynaldo1244 ($247.21 in chips)
Seat 5: mrdust1 ($260.98 in chips)
Seat 6: ColonelPhorbin ($48.81 in chips)
MiltonBradley: posts small blind $1
RAZOR99999: posts big blind $2
*** HOLE CARDS ***
bazman125: folds
reynaldo1244: folds
mrdust1: folds
ColonelPhorbin: raises $2 to $4
MiltonBradley: folds
RAZOR99999: calls $2
*** FLOP *** [8d 7c Qs]
RAZOR99999: checks
ColonelPhorbin: checks
*** TURN *** [8d 7c Qs] [8c]
RAZOR99999: checks
ColonelPhorbin: checks
*** RIVER *** [8d 7c Qs 8c] [Ts]
RAZOR99999: bets $8.55
ColonelPhorbin: folds
Uncalled bet ($8.55) returned to RAZOR99999
RAZOR99999 collected $8.55 from pot
RAZOR99999: doesn't show hand
*** SUMMARY ***
Total pot $9 | Rake $0.45
Board [8d 7c Qs 8c Ts]
Seat 1: MiltonBradley (small blind) folded before Flop
Seat 2: RAZOR99999 (big blind) collected ($8.55)
Seat 3: bazman125 folded before Flop (didn't bet)
Seat 4: reynaldo1244 folded before Flop (didn't bet)
Seat 5: mrdust1 folded before Flop (didn't bet)
Seat 6: ColonelPhorbin (button) folded on the River


PokerStars Hand #232993278588:  Hold'em No Limit ($1/$2 USD) - 2022/01/16 13:47:39 ET
Table 'Atalante' 6-max Seat #1 is the button
Seat 1: MiltonBradley ($200 in chips)
Seat 2: RAZOR99999 ($75.40 in chips)
Seat 3: bazman125 ($216.83 in chips)
Seat 4: reynaldo1244 ($247.21 in chips)
Seat 5: mrdust1 ($260.98 in chips)
Seat 6: ColonelPhorbin ($44.81 in chips)
RAZOR99999: posts small blind $1
bazman125: posts big blind $2
*** HOLE CARDS ***
reynaldo1244: folds
mrdust1: folds
ColonelPhorbin: calls $2
MiltonBradley: raises $4 to $6
RAZOR99999: folds
bazman125: calls $4
ColonelPhorbin: calls $4
*** FLOP *** [4d Ks 9h]
bazman125: checks
ColonelPhorbin: checks
MiltonBradley: bets $5.78
bazman125: folds
ColonelPhorbin: folds
Uncalled bet ($5.78) returned to MiltonBradley
MiltonBradley collected $18.05 from pot
MiltonBradley: doesn't show hand
*** SUMMARY ***
Total pot $19 | Rake $0.95
Board [4d Ks 9h]
Seat 1: MiltonBradley (button) collected ($18.05)
Seat 2: RAZOR99999 (small blind) folded before Flop
Seat 3: bazman125 (big blind) folded on the Flop
Seat 4: reynaldo1244 folded before Flop (didn't bet)
Seat 5: mrdust1 folded before Flop (didn't bet)
Seat 6: ColonelPhorbin folded on the Flop


PokerStars Hand #232993278836:  Hold'em No Limit ($1/$2 USD) - 2022/01/16 13:48:24 ET
Table 'Atalante' 6-max Seat #2 is the button
Seat 1: MiltonBradley ($212.05 in chips)
Seat 2: RAZOR99999 ($74.40 in chips)
Seat 3: bazman125 ($210.83 in chips)
Seat 4: reynaldo1244 ($247.21 in chips)
Seat 5: mrdust1 ($260.98 in chips)
Seat 6: ColonelPhorbin ($38.81 in chips)
bazman125: posts small blind $1
reynaldo1244: posts big blind $2
*** HOLE CARDS ***
mrdust1: raises $3 to $5
ColonelPhorbin: folds
MiltonBradley: folds
RAZOR99999: calls $5
bazman125: calls $4
reynaldo1244: folds
*** FLOP *** [4d 7h Td]
bazman125: checks
mrdust1: bets $5.33
RAZOR99999: folds
bazman125: folds
Uncalled bet ($5.33) returned to mrdust1
mrdust1 collected $16.15 from pot
mrdust1: doesn't show hand
*** SUMMARY ***
Total pot $17 | Rake $0.85
Board [4d 7h Td]
Seat 1: MiltonBradley folded before Flop (didn't bet)
Seat 2: RAZOR99999 (button) folded on the Flop
Seat 3: bazman125 (small blind) folded on the Flop
Seat 4: reynaldo1244 (big blind) folded before Flop
Seat 5: mrdust1 collected ($16.15)
Seat 6: ColonelPhorbin folded before Flop (didn't bet)


PokerStars Hand #232993279059:  Hold'em No Limit ($1/$2 USD) - 2022/01/16 13:49:00 ET
Table 'Atalante' 6-max Seat #3 is the button
Seat 1: MiltonBradley ($212.05 in chips)
Seat 2: RAZOR99999 ($69.40 in chips)
Seat 3: bazman125 ($205.83 in chips)
Seat 4: reynaldo1244 ($245.21 in chips)
Seat 5: mrdust1 ($272.13 in chips)
Seat 6: ColonelPhorbin ($38.81 in chips)
reynaldo1244: posts small blind $1
mrdust1: posts big blind $2
*** HOLE CARDS ***
ColonelPhorbin has timed out
ColonelPhorbin: folds
MiltonBradley: folds
RAZOR99999: folds
bazman125: folds
reynaldo1244: folds
Uncalled bet ($1) returned to mrdust1
mrdust1 collected $2 from pot
mrdust1: doesn't show hand
*** SUMMARY ***
Total pot $2 | Rake $0
Seat 1: MiltonBradley folded before Flop (didn't bet)
Seat 2: RAZOR99999 folded before Flop (didn't bet)
Seat 3: bazman125 (button) folded before Flop (didn't bet)
Seat 4: reynaldo1244 (small blind) folded before Flop
Seat 5: mrdust1 (big blind) collected ($2)
Seat 6: ColonelPhorbin folded before Flop (didn't bet)


PokerStars Hand #232993279213:  Hold'em No Limit ($1/$2 USD) - 2022/01/16 13:49:24 ET
Table 'Atalante' 6-max Seat #4 is the button
Seat 1: MiltonBradley ($212.05 in chips)
Seat 2: RAZOR99999 ($69.40 in chips)
Seat 3: bazman125 ($205.83 in chips)
Seat 4: reynaldo1244 ($244.21 in chips)
Seat 5: mrdust1 ($273.13 in chips)
Seat 6: ColonelPhorbin ($38.81 in chips)
mrdust1: posts small blind $1
ColonelPhorbin: posts big blind $2
*** HOLE CARDS ***
MiltonBradley: folds
RAZOR99999: folds
bazman125: calls $2
reynaldo1244: folds
mrdust1: raises $6 to $8
ColonelPhorbin: calls $6
bazman125: calls $6
*** FLOP *** [Qc 4d 9d]
mrdust1: bets $10.03
ColonelPhorbin: raises $20.78 to $30.81 and is all-in
bazman125: folds
mrdust1: calls $20.78
*** TURN *** [Qc 4d 9d] [Kh]
*** RIVER *** [Qc 4d 9d Kh] [Ah]
*** SHOW DOWN ***
mrdust1: shows [Ad 7d] (a pair of Aces)
ColonelPhorbin: shows [Kd Qd] (two pair, Kings and Queens)
ColonelPhorbin collected $82.62 from pot
*** SUMMARY ***
Total pot $85.62 | Rake $3
Board [Qc 4d 9d Kh Ah]
Seat 1: MiltonBradley folded before Flop (didn't bet)
Seat 2: RAZOR99999 folded before Flop (didn't bet)
Seat 3: bazman125 folded on the Flop
Seat 4: reynaldo1244 (button) folded before Flop (didn't bet)
Seat 5: mrdust1 (small blind) showed [Ad 7d] and lost with a pair of Aces
Seat 6: ColonelPhorbin (big blind) showed [Kd Qd] and won ($82.62) with two pair, Kings and Queens


PokerStars Hand #232993279580:  Hold'em No Limit ($1/$2 USD) - 2022/01/16 13:50:22 ET
Table 'Atalante' 6-max Seat #5 is the button
Seat 1: MiltonBradley ($212.05 in chips)
Seat 2: RAZOR99999 ($69.40 in chips)
Seat 3: bazman125 ($197.83 in chips)
Seat 4: reynaldo1244 ($244.21 in chips)
Seat 5: mrdust1 ($234.32 in chips)
Seat 6: ColonelPhorbin ($82.62 in chips)
ColonelPhorbin: posts small blind $1
MiltonBradley: posts big blind $2
*** HOLE CARDS ***
RAZOR99999: folds
bazman125: calls $2
reynaldo1244: folds
mrdust1: folds
ColonelPhorbin: calls $1
MiltonBradley: raises $9 to $11
bazman125: folds
ColonelPhorbin: folds
Uncalled bet ($9) returned to MiltonBradley
MiltonBradley collected $6 from pot
MiltonBradley: doesn't show hand
*** SUMMARY ***
Total pot $6 | Rake $0
Seat 1: MiltonBradley (big blind) collected ($6)
Seat 2: RAZOR99999 folded before Flop (didn't bet)
Seat 3: bazman125 folded before Flop
Seat 4: reynaldo1244 folded before Flop (didn't bet)
Seat 5: mrdust1 (button) folded before Flop (didn't bet)
Seat 6: ColonelPhorbin (small blind) folded before Flop


PokerStars Hand #232993279862:  Hold'em No Limit ($1/$2 USD) - 2022/01/16 13:51:08 ET
Table 'Atalante' 6-max Seat #6 is the button
Seat 1: MiltonBradley ($216.05 in chips)
Seat 2: RAZOR99999 ($69.40 in chips)
Seat 3: bazman125 ($195.83 in chips)
Seat 4: reynaldo1244 ($244.21 in chips)
Seat 5: mrdust1 ($234.32 in chips)
Seat 6: ColonelPhorbin ($80.62 in chips)
MiltonBradley: posts small blind $1
RAZOR99999: posts big blind $2
*** HOLE CARDS ***
bazman125: folds
reynaldo1244: folds
mrdust1: folds
ColonelPhorbin: raises $2 to $4
MiltonBradley: folds
RAZOR99999: calls $2
*** FLOP *** [4d 5s Kd]
RAZOR99999: checks
ColonelPhorbin: checks
*** TURN *** [4d 5s Kd] [4c]
RAZOR99999: checks
ColonelPhorbin: bets $8.55
RAZOR99999: folds
Uncalled bet ($8.55) returned to ColonelPhorbin
ColonelPhorbin collected $8.55 from pot
*** SUMMARY ***
Total pot $9 | Rake $0.45
Board [4d 5s Kd 4c]
Seat 1: MiltonBradley (small blind) folded before Flop
Seat 2: RAZOR99999 (big blind) folded on the Turn
Seat 3: bazman125 folded before Flop (didn't bet)
Seat 4: reynaldo1244 folded before Flop (didn't bet)
Seat 5: mrdust1 folded before Flop (didn't bet)
Seat 6: ColonelPhorbin (button) collected ($8.55)


PokerStars Hand #232993371040:  Hold'em No Limit ($1/$2 USD) - 2022/01/16 13:51:37 ET
Table 'Atalante' 6-max Seat #1 is the button
Seat 1: MiltonBradley ($215.05 in chips)
Seat 2: RAZOR99999 ($65.40 in chips)
Seat 3: bazman125 ($195.83 in chips)
Seat 4: reynaldo1244 ($244.21 in chips)
Seat 5: mrdust1 ($234.32 in chips)
Seat 6: ColonelPhorbin ($85.17 in chips)
RAZOR99999: posts small blind $1
bazman125: posts big blind $2
*** HOLE CARDS ***
reynaldo1244: folds
mrdust1: folds
ColonelPhorbin: calls $2
MiltonBradley: folds
RAZOR99999: folds
bazman125: checks
*** FLOP *** [3s 4d 8c]
bazman125: checks
ColonelPhorbin: checks
*** TURN *** [3s 4d 8c] [5h]
bazman125: checks
ColonelPhorbin: checks
*** RIVER *** [3s 4d 8c 5h] [Js]
bazman125: checks
ColonelPhorbin: bets $4.75
bazman125: folds
Uncalled bet ($4.75) returned to ColonelPhorbin
ColonelPhorbin collected $4.75 from pot
*** SUMMARY ***
Total pot $5 | Rake $0.25
Board [3s 4d 8c 5h Js]
Seat 1: MiltonBradley (button) folded before Flop (didn't bet)
Seat 2: RAZOR99999 (small blind) folded before Flop
Seat 3: bazman125 (big blind) folded on the River
Seat 4: reynaldo1244 folded before Flop (didn't bet)
Seat 5: mrdust1 folded before Flop (didn't bet)
Seat 6: ColonelPhorbin collected ($4.75)


PokerStars Hand #232993371376:  Hold'em No Limit ($1/$2 USD) - 2022/01/16 13:52:25 ET
Table 'Atalante' 6-max Seat #2 is the button
Seat 1: MiltonBradley ($215.05 in chips)
Seat 2: RAZOR99999 ($64.40 in chips)
Seat 3: bazman125 ($193.83 in chips)
Seat 4: reynaldo1244 ($244.21 in chips)
Seat 5: mrdust1 ($234.32 in chips)
Seat 6: ColonelPhorbin ($87.92 in chips)
bazman125: posts small blind $1
reynaldo1244: posts big blind $2
*** HOLE CARDS ***
mrdust1: folds
ColonelPhorbin: folds
MiltonBradley: folds
RAZOR99999: folds
bazman125: raises $2 to $4
reynaldo1244: calls $2
*** FLOP *** [Jc 6h Qh]
bazman125: bets $2
reynaldo1244: folds
Uncalled bet ($2) returned to bazman125
bazman125 collected $7.60 from pot
*** SUMMARY ***
Total pot $8 | Rake $0.40
Board [Jc 6h Qh]
Seat 1: MiltonBradley folded before Flop (didn't bet)
Seat 2: RAZOR99999 (button) folded before Flop (didn't bet)
Seat 3: bazman125 (small blind) collected ($7.60)
Seat 4: reynaldo1244 (big blind) folded on the Flop
Seat 5: mrdust1 folded before Flop (didn't bet)
Seat 6: ColonelPhorbin folded before Flop (didn't bet)


PokerStars Hand #232993371545:  Hold'em No Limit ($1/$2 USD) - 2022/01/16 13:52:52 ET
Table 'Atalante' 6-max Seat #3 is the button
Seat 1: MiltonBradley ($215.05 in chips)
Seat 2: RAZOR99999 ($64.40 in chips)
Seat 3: bazman125 ($197.43 in chips)
Seat 4: reynaldo1244 ($240.21 in chips)
Seat 5: mrdust1 ($234.32 in chips)
Seat 6: ColonelPhorbin ($87.92 in chips)
reynaldo1244: posts small blind $1
mrdust1: posts big blind $2
*** HOLE CARDS ***
ColonelPhorbin: folds
MiltonBradley: folds
RAZOR99999: folds
bazman125: calls $2
reynaldo1244: folds
mrdust1: raises $4.60 to $6.60
bazman125: folds
Uncalled bet ($4.60) returned to mrdust1
mrdust1 collected $5 from pot
mrdust1: doesn't show hand
*** SUMMARY ***
Total pot $5 | Rake $0
Seat 1: MiltonBradley folded before Flop (didn't bet)
Seat 2: RAZOR99999 folded before Flop (didn't bet)
Seat 3: bazman125 (button) folded before Flop
Seat 4: reynaldo1244 (small blind) folded before Flop
Seat 5: mrdust1 (big blind) collected ($5)
Seat 6: ColonelPhorbin folded before Flop (didn't bet)


PokerStars Hand #232993371747:  Hold'em No Limit ($1/$2 USD) - 2022/01/16 13:53:20 ET
Table 'Atalante' 6-max Seat #4 is the button
Seat 1: MiltonBradley ($215.05 in chips)
Seat 2: RAZOR99999 ($64.40 in chips)
Seat 3: bazman125 ($195.43 in chips)
Seat 4: reynaldo1244 ($239.21 in chips)
Seat 5: mrdust1 ($237.32 in chips)
Seat 6: ColonelPhorbin ($87.92 in chips)
mrdust1: posts small blind $1
ColonelPhorbin: posts big blind $2
*** HOLE CARDS ***
MiltonBradley: folds
RAZOR99999: raises $4 to $6
bazman125: folds
reynaldo1244: folds
mrdust1: folds
ColonelPhorbin: calls $4
*** FLOP *** [Qc Td Jc]
ColonelPhorbin: checks
RAZOR99999: bets $6.18
ColonelPhorbin: calls $6.18
*** TURN *** [Qc Td Jc] [9c]
ColonelPhorbin: checks
RAZOR99999: bets $12
ColonelPhorbin: calls $12
*** RIVER *** [Qc Td Jc 9c] [Ac]
ColonelPhorbin: checks
RAZOR99999: checks
*** SHOW DOWN ***
ColonelPhorbin: shows [9h Qh] (two pair, Queens and Nines)
RAZOR99999: shows [8s As] (a straight, Eight to Queen)
RAZOR99999 collected $46.89 from pot
*** SUMMARY ***
Total pot $49.36 | Rake $2.47
Board [Qc Td Jc 9c Ac]
Seat 1: MiltonBradley folded before Flop (didn't bet)
Seat 2: RAZOR99999 showed [8s As] and won ($46.89) with a straight, Eight to Queen
Seat 3: bazman125 folded before Flop (didn't bet)
Seat 4: reynaldo1244 (button) folded before Flop (didn't bet)
Seat 5: mrdust1 (small blind) folded before Flop
Seat 6: ColonelPhorbin (big blind) showed [9h Qh] and lost with two pair, Queens and Nines


PokerStars Hand #232993372143:  Hold'em No Limit ($1/$2 USD) - 2022/01/16 13:54:18 ET
Table 'Atalante' 6-max Seat #5 is the button
Seat 1: MiltonBradley ($215.05 in chips)
Seat 2: RAZOR99999 ($87.11 in chips)
Seat 3: bazman125 ($195.43 in chips)
Seat 4: reynaldo1244 ($239.21 in chips)
Seat 5: mrdust1 ($236.32 in chips)
Seat 6: ColonelPhorbin ($63.74 in chips)
ColonelPhorbin: posts small blind $1
MiltonBradley: posts big blind $2
*** HOLE CARDS ***
RAZOR99999: folds
bazman125: folds
reynaldo1244: folds
mrdust1: raises $3 to $5
ColonelPhorbin: calls $4
MiltonBradley: folds
*** FLOP *** [Kd Js 5c]
ColonelPhorbin: bets $11.40
mrdust1: calls $11.40
*** TURN *** [Kd Js 5c] [8h]
ColonelPhorbin: bets $22
mrdust1: raises $58.57 to $80.57
ColonelPhorbin: calls $25.34 and is all-in
Uncalled bet ($33.23) returned to mrdust1
*** RIVER *** [Kd Js 5c 8h] [5d]
*** SHOW DOWN ***
ColonelPhorbin: shows [Kc Qd] (two pair, Kings and Fives)
mrdust1: shows [Ks Qc] (two pair, Kings and Fives)
ColonelPhorbin collected $63.24 from pot
mrdust1 collected $63.24 from pot
*** SUMMARY ***
Total pot $129.48 | Rake $3
Board [Kd Js 5c 8h 5d]
Seat 1: MiltonBradley (big blind) folded before Flop
Seat 2: RAZOR99999 folded before Flop (didn't bet)
Seat 3: bazman125 folded before Flop (didn't bet)
Seat 4: reynaldo1244 folded before Flop (didn't bet)
Seat 5: mrdust1 (button) showed [Ks Qc] and won ($63.24) with two pair, Kings and Fives
Seat 6: ColonelPhorbin (small blind) showed [Kc Qd] and won ($63.24) with two pair, Kings and Fives


PokerStars Hand #232993372552:  Hold'em No Limit ($1/$2 USD) - 2022/01/16 13:55:17 ET
Table 'Atalante' 6-max Seat #6 is the button
Seat 1: MiltonBradley ($213.05 in chips)
Seat 2: RAZOR99999 ($87.11 in chips)
Seat 3: bazman125 ($200 in chips)
Seat 4: reynaldo1244 ($239.21 in chips)
Seat 5: mrdust1 ($235.82 in chips)
Seat 6: ColonelPhorbin ($63.24 in chips)
MiltonBradley: posts small blind $1
RAZOR99999: posts big blind $2
*** HOLE CARDS ***
bazman125: folds
reynaldo1244: folds
mrdust1: folds
ColonelPhorbin: folds
MiltonBradley: raises $4 to $6
RAZOR99999: folds
Uncalled bet ($4) returned to MiltonBradley
MiltonBradley collected $4 from pot
MiltonBradley: doesn't show hand
*** SUMMARY ***
Total pot $4 | Rake $0
Seat 1: MiltonBradley (small blind) collected ($4)
Seat 2: RAZOR99999 (big blind) folded before Flop
Seat 3: bazman125 folded before Flop (didn't bet)
Seat 4: reynaldo1244 folded before Flop (didn't bet)
Seat 5: mrdust1 folded before Flop (didn't bet)
Seat 6: ColonelPhorbin (button) folded before Flop (didn't bet)


PokerStars Hand #232993372646:  Hold'em No Limit ($1/$2 USD) - 2022/01/16 13:55:32 ET
Table 'Atalante' 6-max Seat #1 is the button
Seat 1: MiltonBradley ($215.05 in chips)
Seat 2: RAZOR99999 ($85.11 in chips)
Seat 3: bazman125 ($200 in chips)
Seat 4: reynaldo1244 ($239.21 in chips)
Seat 5: mrdust1 ($235.82 in chips)
Seat 6: ColonelPhorbin ($63.24 in chips)
RAZOR99999: posts small blind $1
bazman125: posts big blind $2
*** HOLE CARDS ***
reynaldo1244: folds
mrdust1: folds
ColonelPhorbin: calls $2
MiltonBradley: folds
RAZOR99999: folds
bazman125: checks
*** FLOP *** [7h Jh 8h]
bazman125: bets $2
ColonelPhorbin: calls $2
*** TURN *** [7h Jh 8h] [7c]
bazman125: checks
ColonelPhorbin: bets $8.55
bazman125: folds
Uncalled bet ($8.55) returned to ColonelPhorbin
ColonelPhorbin collected $8.55 from pot
*** SUMMARY ***
Total pot $9 | Rake $0.45
Board [7h Jh 8h 7c]
Seat 1: MiltonBradley (button) folded before Flop (didn't bet)
Seat 2: RAZOR99999 (small blind) folded before Flop
Seat 3: bazman125 (big blind) folded on the Turn
Seat 4: reynaldo1244 folded before Flop (didn't bet)
Seat 5: mrdust1 folded before Flop (didn't bet)
Seat 6: ColonelPhorbin collected ($8.55)


PokerStars Hand #232993372916:  Hold'em No Limit ($1/$2 USD) - 2022/01/16 13:56:17 ET
Table 'Atalante' 6-max Seat #2 is the button
Seat 1: MiltonBradley ($215.05 in chips)
Seat 2: RAZOR99999 ($84.11 in chips)
Seat 3: bazman125 ($196 in chips)
Seat 4: reynaldo1244 ($239.21 in chips)
Seat 5: mrdust1 ($235.82 in chips)
Seat 6: ColonelPhorbin ($67.79 in chips)
bazman125: posts small blind $1
reynaldo1244: posts big blind $2
*** HOLE CARDS ***
mrdust1: folds
ColonelPhorbin: folds
MiltonBradley: raises $2.42 to $4.42
RAZOR99999: folds
bazman125: folds
reynaldo1244: folds
Uncalled bet ($2.42) returned to MiltonBradley
MiltonBradley collected $5 from pot
MiltonBradley: doesn't show hand
*** SUMMARY ***
Total pot $5 | Rake $0
Seat 1: MiltonBradley collected ($5)
Seat 2: RAZOR99999 (button) folded before Flop (didn't bet)
Seat 3: bazman125 (small blind) folded before Flop
Seat 4: reynaldo1244 (big blind) folded before Flop
Seat 5: mrdust1 folded before Flop (didn't bet)
Seat 6: ColonelPhorbin folded before Flop (didn't bet)


PokerStars Hand #232993373012:  Hold'em No Limit ($1/$2 USD) - 2022/01/16 13:56:34 ET
Table 'Atalante' 6-max Seat #3 is the button
Seat 1: MiltonBradley ($218.05 in chips)
Seat 2: RAZOR99999 ($84.11 in chips)
Seat 3: bazman125 ($197.43 in chips)
Seat 4: reynaldo1244 ($237.21 in chips)
Seat 5: mrdust1 ($235.82 in chips)
Seat 6: ColonelPhorbin ($67.79 in chips)
reynaldo1244: posts small blind $1
mrdust1: posts big blind $2
*** HOLE CARDS ***
ColonelPhorbin: folds
MiltonBradley: raises $2.42 to $4.42
RAZOR99999: folds
bazman125: folds
reynaldo1244: folds
mrdust1: folds
Uncalled bet ($2.42) returned to MiltonBradley
MiltonBradley collected $5 from pot
MiltonBradley: doesn't show hand
*** SUMMARY ***
Total pot $5 | Rake $0
Seat 1: MiltonBradley collected ($5)
Seat 2: RAZOR99999 folded before Flop (didn't bet)
Seat 3: bazman125 (button) folded before Flop (didn't bet)
Seat 4: reynaldo1244 (small blind) folded before Flop
Seat 5: mrdust1 (big blind) folded before Flop
Seat 6: ColonelPhorbin folded before Flop (didn't bet)


PokerStars Hand #232993373145:  Hold'em No Limit ($1/$2 USD) - 2022/01/16 13:56:54 ET
Table 'Atalante' 6-max Seat #4 is the button
Seat 1: MiltonBradley ($221.05 in chips)
Seat 2: RAZOR99999 ($84.11 in chips)
Seat 3: bazman125 ($197.43 in chips)
Seat 4: reynaldo1244 ($236.21 in chips)
Seat 5: mrdust1 ($233.82 in chips)
Seat 6: ColonelPhorbin ($67.79 in chips)
mrdust1: posts small blind $1
ColonelPhorbin: posts big blind $2
*** HOLE CARDS ***
MiltonBradley: folds
RAZOR99999: folds
bazman125: folds
reynaldo1244: raises $3 to $5
mrdust1: folds
ColonelPhorbin: calls $3
*** FLOP *** [9s Tc 7c]
ColonelPhorbin: checks
reynaldo1244: checks
*** TURN *** [9s Tc 7c] [Ah]
ColonelPhorbin: bets $10.45
reynaldo1244: calls $10.45
*** RIVER *** [9s Tc 7c Ah] [4d]
ColonelPhorbin: checks
reynaldo1244: checks
*** SHOW DOWN ***
ColonelPhorbin: shows [6d 7s] (a pair of Sevens)
reynaldo1244: shows [As Jc] (a pair of Aces)
reynaldo1244 collected $30.30 from pot
*** SUMMARY ***
Total pot $31.90 | Rake $1.60
Board [9s Tc 7c Ah 4d]
Seat 1: MiltonBradley folded before Flop (didn't bet)
Seat 2: RAZOR99999 folded before Flop (didn't bet)
Seat 3: bazman125 folded before Flop (didn't bet)
Seat 4: reynaldo1244 (button) showed [As Jc] and won ($30.30) with a pair of Aces
Seat 5: mrdust1 (small blind) folded before Flop
Seat 6: ColonelPhorbin (big blind) showed [6d 7s] and lost with a pair of Sevens


PokerStars Hand #232993373374:  Hold'em No Limit ($1/$2 USD) - 2022/01/16 13:57:35 ET
Table 'Atalante' 6-max Seat #5 is the button
Seat 1: MiltonBradley ($221.05 in chips)
Seat 2: RAZOR99999 ($84.11 in chips)
Seat 3: bazman125 ($197.43 in chips)
Seat 4: reynaldo1244 ($251.06 in chips)
Seat 5: mrdust1 ($232.82 in chips)
Seat 6: ColonelPhorbin ($52.34 in chips)
ColonelPhorbin: posts small blind $1
MiltonBradley: posts big blind $2
*** HOLE CARDS ***
RAZOR99999: raises $4 to $6
bazman125: folds
reynaldo1244: folds
mrdust1: raises $9 to $15
ColonelPhorbin: calls $14
MiltonBradley: calls $13
RAZOR99999: folds
*** FLOP *** [3s 6c Js]
ColonelPhorbin: bets $37.34 and is all-in
MiltonBradley: folds
mrdust1: folds
Uncalled bet ($37.34) returned to ColonelPhorbin
ColonelPhorbin collected $48.45 from pot
*** SUMMARY ***
Total pot $51 | Rake $2.55
Board [3s 6c Js]
Seat 1: MiltonBradley (big blind) folded on the Flop
Seat 2: RAZOR99999 folded before Flop
Seat 3: bazman125 folded before Flop (didn't bet)
Seat 4: reynaldo1244 folded before Flop (didn't bet)
Seat 5: mrdust1 (button) folded on the Flop
Seat 6: ColonelPhorbin (small blind) collected ($48.45)


PokerStars Hand #232993373627:  Hold'em No Limit ($1/$2 USD) - 2022/01/16 13:58:21 ET
Table 'Atalante' 6-max Seat #6 is the button
Seat 1: MiltonBradley ($206.05 in chips)
Seat 2: RAZOR99999 ($78.11 in chips)
Seat 3: bazman125 ($197.43 in chips)
Seat 4: reynaldo1244 ($251.06 in chips)
Seat 5: mrdust1 ($217.82 in chips)
Seat 6: ColonelPhorbin ($85.79 in chips)
MiltonBradley: posts small blind $1
RAZOR99999: posts big blind $2
*** HOLE CARDS ***
bazman125: calls $2
reynaldo1244: folds
mrdust1: folds
ColonelPhorbin: raises $2 to $4
MiltonBradley: folds
RAZOR99999: calls $2
bazman125: raises $24 to $28
ColonelPhorbin: calls $24
RAZOR99999: folds
*** FLOP *** [Qc As 8d]
bazman125: bets $58
ColonelPhorbin: calls $57.79 and is all-in
Uncalled bet ($0.21) returned to bazman125
*** TURN *** [Qc As 8d] [9d]
*** RIVER *** [Qc As 8d 9d] [7d]
*** SHOW DOWN ***
bazman125: shows [Kc Ad] (a pair of Aces)
ColonelPhorbin: shows [Ah 2h] (a pair of Aces - lower kicker)
bazman125 collected $173.58 from pot
*** SUMMARY ***
Total pot $176.58 | Rake $3
Board [Qc As 8d 9d 7d]
Seat 1: MiltonBradley (small blind) folded before Flop
Seat 2: RAZOR99999 (big blind) folded before Flop
Seat 3: bazman125 showed [Kc Ad] and won ($173.58) with a pair of Aces
Seat 4: reynaldo1244 folded before Flop (didn't bet)
Seat 5: mrdust1 folded before Flop (didn't bet)
Seat 6: ColonelPhorbin (button) showed [Ah 2h] and lost with a pair of Aces


PokerStars Hand #232993373929:  Hold'em No Limit ($1/$2 USD) - 2022/01/16 13:59:14 ET
Table 'Atalante' 6-max Seat #1 is the button
Seat 1: MiltonBradley ($205.05 in chips)
Seat 2: RAZOR99999 ($74.11 in chips)
Seat 3: bazman125 ($285.22 in chips)
Seat 4: reynaldo1244 ($251.06 in chips)
Seat 5: mrdust1 ($217.82 in chips)
RAZOR99999: posts small blind $1
bazman125: posts big blind $2
*** HOLE CARDS ***
ColonelPhorbin leaves the table
reynaldo1244: folds
mrdust1: raises $3 to $5
MiltonBradley: folds
RAZOR99999: folds
Mab471 joins the table at seat #6
bazman125: calls $3
*** FLOP *** [Js 9d 3h]
bazman125: checks
mrdust1: checks
*** TURN *** [Js 9d 3h] [7h]
bazman125: bets $5.23
mrdust1: calls $5.23
*** RIVER *** [Js 9d 3h 7h] [Tc]
bazman125: checks
mrdust1: checks
*** SHOW DOWN ***
bazman125: shows [8c 9c] (a straight, Seven to Jack)
mrdust1: mucks hand
bazman125 collected $20.39 from pot
*** SUMMARY ***
Total pot $21.46 | Rake $1.07
Board [Js 9d 3h 7h Tc]
Seat 1: MiltonBradley (button) folded before Flop (didn't bet)
Seat 2: RAZOR99999 (small blind) folded before Flop
Seat 3: bazman125 (big blind) showed [8c 9c] and won ($20.39) with a straight, Seven to Jack
Seat 4: reynaldo1244 folded before Flop (didn't bet)
Seat 5: mrdust1 mucked


PokerStars Hand #232993374265:  Hold'em No Limit ($1/$2 USD) - 2022/01/16 14:00:13 ET
Table 'Atalante' 6-max Seat #2 is the button
Seat 1: MiltonBradley ($205.05 in chips)
Seat 2: RAZOR99999 ($73.11 in chips)
Seat 3: bazman125 ($295.38 in chips)
Seat 4: reynaldo1244 ($251.06 in chips)
Seat 5: mrdust1 ($207.59 in chips)
bazman125: posts small blind $1
reynaldo1244: posts big blind $2
Mab471: sits out
*** HOLE CARDS ***
mrdust1: folds
MiltonBradley: folds
RAZOR99999: raises $5 to $7
bazman125: folds
reynaldo1244: folds
Uncalled bet ($5) returned to RAZOR99999
RAZOR99999 collected $5 from pot
RAZOR99999: doesn't show hand
*** SUMMARY ***
Total pot $5 | Rake $0
Seat 1: MiltonBradley folded before Flop (didn't bet)
Seat 2: RAZOR99999 (button) collected ($5)
Seat 3: bazman125 (small blind) folded before Flop
Seat 4: reynaldo1244 (big blind) folded before Flop
Seat 5: mrdust1 folded before Flop (didn't bet)


PokerStars Hand #232993374364:  Hold'em No Limit ($1/$2 USD) - 2022/01/16 14:00:29 ET
Table 'Atalante' 6-max Seat #3 is the button
Seat 1: MiltonBradley ($205.05 in chips)
Seat 2: RAZOR99999 ($76.11 in chips)
Seat 3: bazman125 ($294.38 in chips)
Seat 4: reynaldo1244 ($249.06 in chips)
Seat 5: mrdust1 ($207.59 in chips)
reynaldo1244: posts small blind $1
mrdust1: posts big blind $2
Mab471: sits out
*** HOLE CARDS ***
MiltonBradley: folds
RAZOR99999: folds
bazman125: calls $2
reynaldo1244: folds
mrdust1: checks
*** FLOP *** [Tc Ah 2h]
mrdust1: checks
bazman125: bets $2.38
mrdust1: folds
Uncalled bet ($2.38) returned to bazman125
bazman125 collected $4.75 from pot
*** SUMMARY ***
Total pot $5 | Rake $0.25
Board [Tc Ah 2h]
Seat 1: MiltonBradley folded before Flop (didn't bet)
Seat 2: RAZOR99999 folded before Flop (didn't bet)
Seat 3: bazman125 (button) collected ($4.75)
Seat 4: reynaldo1244 (small blind) folded before Flop
Seat 5: mrdust1 (big blind) folded on the Flop


PokerStars Hand #232993374674:  Hold'em No Limit ($1/$2 USD) - 2022/01/16 14:01:22 ET
Table 'Atalante' 6-max Seat #4 is the button
Seat 1: MiltonBradley ($205.05 in chips)
Seat 2: RAZOR99999 ($76.11 in chips)
Seat 3: bazman125 ($297.13 in chips)
Seat 4: reynaldo1244 ($248.06 in chips)
Seat 5: mrdust1 ($205.59 in chips)
Seat 6: Mab471 ($200 in chips)
mrdust1: posts small blind $1
Mab471: posts big blind $2
*** HOLE CARDS ***
MiltonBradley: folds
RAZOR99999: raises $4 to $6
bazman125: calls $6
reynaldo1244: folds
mrdust1: folds
Mab471: folds
*** FLOP *** [4s Th Kd]
RAZOR99999: bets $7
bazman125: calls $7
*** TURN *** [4s Th Kd] [Qh]
RAZOR99999: checks
bazman125: bets $13.78
RAZOR99999: folds
Uncalled bet ($13.78) returned to bazman125
bazman125 collected $27.55 from pot
*** SUMMARY ***
Total pot $29 | Rake $1.45
Board [4s Th Kd Qh]
Seat 1: MiltonBradley folded before Flop (didn't bet)
Seat 2: RAZOR99999 folded on the Turn
Seat 3: bazman125 collected ($27.55)
Seat 4: reynaldo1244 (button) folded before Flop (didn't bet)
Seat 5: mrdust1 (small blind) folded before Flop
Seat 6: Mab471 (big blind) folded before Flop


PokerStars Hand #232993375059:  Hold'em No Limit ($1/$2 USD) - 2022/01/16 14:02:24 ET
Table 'Atalante' 6-max Seat #5 is the button
Seat 1: MiltonBradley ($205.05 in chips)
Seat 2: RAZOR99999 ($63.11 in chips)
Seat 3: bazman125 ($311.68 in chips)
Seat 4: reynaldo1244 ($248.06 in chips)
Seat 5: mrdust1 ($204.59 in chips)
Seat 6: Mab471 ($200 in chips)
Mab471: posts small blind $1
MiltonBradley: posts big blind $2
*** HOLE CARDS ***
RAZOR99999 has timed out
RAZOR99999: folds
bazman125: folds
reynaldo1244: raises $3 to $5
mrdust1: calls $5
Mab471: folds
MiltonBradley: raises $17 to $22
reynaldo1244: calls $17
mrdust1: calls $17
*** FLOP *** [9s Ad 9d]
MiltonBradley: checks
reynaldo1244: checks
mrdust1: bets $21.12
MiltonBradley: calls $21.12
reynaldo1244: folds
*** TURN *** [9s Ad 9d] [2c]
MiltonBradley: checks
mrdust1: bets $51.28
MiltonBradley: folds
Uncalled bet ($51.28) returned to mrdust1
mrdust1 collected $106.24 from pot
mrdust1: doesn't show hand
*** SUMMARY ***
Total pot $109.24 | Rake $3
Board [9s Ad 9d 2c]
Seat 1: MiltonBradley (big blind) folded on the Turn
Seat 2: RAZOR99999 folded before Flop (didn't bet)
Seat 3: bazman125 folded before Flop (didn't bet)
Seat 4: reynaldo1244 folded on the Flop
Seat 5: mrdust1 (button) collected ($106.24)
Seat 6: Mab471 (small blind) folded before Flop


PokerStars Hand #232993375879:  Hold'em No Limit ($1/$2 USD) - 2022/01/16 14:04:37 ET
Table 'Atalante' 6-max Seat #6 is the button
Seat 1: MiltonBradley ($200 in chips)
Seat 2: RAZOR99999 ($63.11 in chips)
Seat 3: bazman125 ($311.68 in chips)
Seat 4: reynaldo1244 ($226.06 in chips)
Seat 5: mrdust1 ($267.71 in chips)
Seat 6: Mab471 ($200 in chips)
MiltonBradley: posts small blind $1
RAZOR99999: posts big blind $2
*** HOLE CARDS ***
bazman125: folds
reynaldo1244: folds
mrdust1: raises $3 to $5
Mab471: folds
MiltonBradley: raises $15.60 to $20.60
RAZOR99999: folds
mrdust1: calls $15.60
*** FLOP *** [8c 6c 8d]
MiltonBradley: checks
mrdust1: checks
*** TURN *** [8c 6c 8d] [Ks]
MiltonBradley: bets $13.13
mrdust1: calls $13.13
*** RIVER *** [8c 6c 8d Ks] [Qd]
MiltonBradley: checks
mrdust1: bets $50.51
MiltonBradley: folds
Uncalled bet ($50.51) returned to mrdust1
mrdust1 collected $66.46 from pot
mrdust1: doesn't show hand
*** SUMMARY ***
Total pot $69.46 | Rake $3
Board [8c 6c 8d Ks Qd]
Seat 1: MiltonBradley (small blind) folded on the River
Seat 2: RAZOR99999 (big blind) folded before Flop
Seat 3: bazman125 folded before Flop (didn't bet)
Seat 4: reynaldo1244 folded before Flop (didn't bet)
Seat 5: mrdust1 collected ($66.46)
Seat 6: Mab471 (button) folded before Flop (didn't bet)


PokerStars Hand #232993376238:  Hold'em No Limit ($1/$2 USD) - 2022/01/16 14:05:37 ET
Table 'Atalante' 6-max Seat #1 is the button
Seat 1: MiltonBradley ($200 in chips)
Seat 2: RAZOR99999 ($61.11 in chips)
Seat 3: bazman125 ($311.68 in chips)
Seat 4: reynaldo1244 ($226.06 in chips)
Seat 5: mrdust1 ($300.44 in chips)
Seat 6: Mab471 ($200 in chips)
RAZOR99999: posts small blind $1
bazman125: posts big blind $2
*** HOLE CARDS ***
reynaldo1244: raises $3 to $5
mrdust1: raises $10 to $15
Mab471: folds
MiltonBradley: folds
RAZOR99999: folds
bazman125: folds
reynaldo1244: calls $10
*** FLOP *** [8h Ad 3d]
reynaldo1244: checks
mrdust1: bets $10.35
reynaldo1244: calls $10.35
*** TURN *** [8h Ad 3d] [3h]
reynaldo1244: checks
mrdust1: bets $38.78
reynaldo1244: folds
Uncalled bet ($38.78) returned to mrdust1
mrdust1 collected $51.02 from pot
mrdust1: doesn't show hand
*** SUMMARY ***
Total pot $53.70 | Rake $2.68
Board [8h Ad 3d 3h]
Seat 1: MiltonBradley (button) folded before Flop (didn't bet)
Seat 2: RAZOR99999 (small blind) folded before Flop
Seat 3: bazman125 (big blind) folded before Flop
Seat 4: reynaldo1244 folded on the Turn
Seat 5: mrdust1 collected ($51.02)
Seat 6: Mab471 folded before Flop (didn't bet)


PokerStars Hand #232993376704:  Hold'em No Limit ($1/$2 USD) - 2022/01/16 14:06:51 ET
Table 'Atalante' 6-max Seat #2 is the button
Seat 1: MiltonBradley ($200 in chips)
Seat 2: RAZOR99999 ($60.11 in chips)
Seat 3: bazman125 ($309.68 in chips)
Seat 4: reynaldo1244 ($200.71 in chips)
Seat 5: mrdust1 ($326.11 in chips)
Seat 6: Mab471 ($200 in chips)
bazman125: posts small blind $1
reynaldo1244: posts big blind $2
*** HOLE CARDS ***
mrdust1: folds
Mab471: folds
MiltonBradley: raises $2.42 to $4.42
RAZOR99999: folds
bazman125: folds
reynaldo1244: folds
Uncalled bet ($2.42) returned to MiltonBradley
MiltonBradley collected $5 from pot
MiltonBradley: doesn't show hand
*** SUMMARY ***
Total pot $5 | Rake $0
Seat 1: MiltonBradley collected ($5)
Seat 2: RAZOR99999 (button) folded before Flop (didn't bet)
Seat 3: bazman125 (small blind) folded before Flop
Seat 4: reynaldo1244 (big blind) folded before Flop
Seat 5: mrdust1 folded before Flop (didn't bet)
Seat 6: Mab471 folded before Flop (didn't bet)


PokerStars Hand #232993376836:  Hold'em No Limit ($1/$2 USD) - 2022/01/16 14:07:11 ET
Table 'Atalante' 6-max Seat #3 is the button
Seat 1: MiltonBradley ($203 in chips)
Seat 2: RAZOR99999 ($60.11 in chips)
Seat 3: bazman125 ($308.68 in chips)
Seat 4: reynaldo1244 ($200 in chips)
Seat 5: mrdust1 ($326.11 in chips)
Seat 6: Mab471 ($200 in chips)
reynaldo1244: posts small blind $1
mrdust1: posts big blind $2
*** HOLE CARDS ***
Mab471: folds
MiltonBradley: folds
RAZOR99999: folds
bazman125: folds
reynaldo1244: folds
Uncalled bet ($1) returned to mrdust1
mrdust1 collected $2 from pot
mrdust1: doesn't show hand
*** SUMMARY ***
Total pot $2 | Rake $0
Seat 1: MiltonBradley folded before Flop (didn't bet)
Seat 2: RAZOR99999 folded before Flop (didn't bet)
Seat 3: bazman125 (button) folded before Flop (didn't bet)
Seat 4: reynaldo1244 (small blind) folded before Flop
Seat 5: mrdust1 (big blind) collected ($2)
Seat 6: Mab471 folded before Flop (didn't bet)


PokerStars Hand #232993376905:  Hold'em No Limit ($1/$2 USD) - 2022/01/16 14:07:21 ET
Table 'Atalante' 6-max Seat #4 is the button
Seat 1: MiltonBradley ($203 in chips)
Seat 2: RAZOR99999 ($60.11 in chips)
Seat 3: bazman125 ($308.68 in chips)
Seat 4: reynaldo1244 ($200 in chips)
Seat 5: mrdust1 ($327.11 in chips)
Seat 6: Mab471 ($200 in chips)
mrdust1: posts small blind $1
Mab471: posts big blind $2
*** HOLE CARDS ***
MiltonBradley: folds
RAZOR99999: folds
bazman125: folds
reynaldo1244: folds
mrdust1: raises $4.60 to $6.60
Mab471: calls $4.60
*** FLOP *** [2d Qs 2h]
mrdust1: bets $5.52
Mab471: folds
Uncalled bet ($5.52) returned to mrdust1
mrdust1 collected $12.54 from pot
mrdust1: doesn't show hand
*** SUMMARY ***
Total pot $13.20 | Rake $0.66
Board [2d Qs 2h]
Seat 1: MiltonBradley folded before Flop (didn't bet)
Seat 2: RAZOR99999 folded before Flop (didn't bet)
Seat 3: bazman125 folded before Flop (didn't bet)
Seat 4: reynaldo1244 (button) folded before Flop (didn't bet)
Seat 5: mrdust1 (small blind) collected ($12.54)
Seat 6: Mab471 (big blind) folded on the Flop


PokerStars Hand #232993377194:  Hold'em No Limit ($1/$2 USD) - 2022/01/16 14:08:01 ET
Table 'Atalante' 6-max Seat #5 is the button
Seat 1: MiltonBradley ($203 in chips)
Seat 2: RAZOR99999 ($60.11 in chips)
Seat 3: bazman125 ($308.68 in chips)
Seat 4: reynaldo1244 ($200 in chips)
Seat 5: mrdust1 ($333.05 in chips)
Seat 6: Mab471 ($200 in chips)
Mab471: posts small blind $1
MiltonBradley: posts big blind $2
*** HOLE CARDS ***
RAZOR99999: folds
bazman125: folds
reynaldo1244: folds
mrdust1: folds
Mab471: folds
Uncalled bet ($1) returned to MiltonBradley
MiltonBradley collected $2 from pot
MiltonBradley: doesn't show hand
*** SUMMARY ***
Total pot $2 | Rake $0
Seat 1: MiltonBradley (big blind) collected ($2)
Seat 2: RAZOR99999 folded before Flop (didn't bet)
Seat 3: bazman125 folded before Flop (didn't bet)
Seat 4: reynaldo1244 folded before Flop (didn't bet)
Seat 5: mrdust1 (button) folded before Flop (didn't bet)
Seat 6: Mab471 (small blind) folded before Flop


PokerStars Hand #232993377269:  Hold'em No Limit ($1/$2 USD) - 2022/01/16 14:08:14 ET
Table 'Atalante' 6-max Seat #6 is the button
Seat 1: MiltonBradley ($204 in chips)
Seat 2: RAZOR99999 ($60.11 in chips)
Seat 3: bazman125 ($308.68 in chips)
Seat 4: reynaldo1244 ($200 in chips)
Seat 5: mrdust1 ($333.05 in chips)
Seat 6: Mab471 ($200 in chips)
MiltonBradley: posts small blind $1
RAZOR99999: posts big blind $2
*** HOLE CARDS ***
bazman125: folds
reynaldo1244: folds
mrdust1: raises $3 to $5
Mab471: folds
MiltonBradley: folds
RAZOR99999: folds
Uncalled bet ($3) returned to mrdust1
mrdust1 collected $5 from pot
mrdust1: doesn't show hand
*** SUMMARY ***
Total pot $5 | Rake $0
Seat 1: MiltonBradley (small blind) folded before Flop
Seat 2: RAZOR99999 (big blind) folded before Flop
Seat 3: bazman125 folded before Flop (didn't bet)
Seat 4: reynaldo1244 folded before Flop (didn't bet)
Seat 5: mrdust1 collected ($5)
Seat 6: Mab471 (button) folded before Flop (didn't bet)


PokerStars Hand #232993377389:  Hold'em No Limit ($1/$2 USD) - 2022/01/16 14:08:33 ET
Table 'Atalante' 6-max Seat #1 is the button
Seat 1: MiltonBradley ($203 in chips)
Seat 2: RAZOR99999 ($58.11 in chips)
Seat 3: bazman125 ($308.68 in chips)
Seat 4: reynaldo1244 ($200 in chips)
Seat 5: mrdust1 ($336.05 in chips)
Seat 6: Mab471 ($200 in chips)
RAZOR99999: posts small blind $1
bazman125: posts big blind $2
*** HOLE CARDS ***
reynaldo1244: folds
mrdust1: folds
Mab471: folds
MiltonBradley: folds
RAZOR99999: folds
Uncalled bet ($1) returned to bazman125
bazman125 collected $2 from pot
*** SUMMARY ***
Total pot $2 | Rake $0
Seat 1: MiltonBradley (button) folded before Flop (didn't bet)
Seat 2: RAZOR99999 (small blind) folded before Flop
Seat 3: bazman125 (big blind) collected ($2)
Seat 4: reynaldo1244 folded before Flop (didn't bet)
Seat 5: mrdust1 folded before Flop (didn't bet)
Seat 6: Mab471 folded before Flop (didn't bet)


PokerStars Hand #232993377502:  Hold'em No Limit ($1/$2 USD) - 2022/01/16 14:08:49 ET
Table 'Atalante' 6-max Seat #2 is the button
Seat 1: MiltonBradley ($203 in chips)
Seat 2: RAZOR99999 ($57.11 in chips)
Seat 3: bazman125 ($309.68 in chips)
Seat 4: reynaldo1244 ($200 in chips)
Seat 5: mrdust1 ($336.05 in chips)
Seat 6: Mab471 ($200 in chips)
bazman125: posts small blind $1
reynaldo1244: posts big blind $2
*** HOLE CARDS ***
mrdust1: folds
Mab471: folds
MiltonBradley: folds
RAZOR99999: folds
bazman125: calls $1
reynaldo1244: checks
*** FLOP *** [9c Th Qd]
bazman125: bets $2
reynaldo1244: folds
Uncalled bet ($2) returned to bazman125
bazman125 collected $3.80 from pot
*** SUMMARY ***
Total pot $4 | Rake $0.20
Board [9c Th Qd]
Seat 1: MiltonBradley folded before Flop (didn't bet)
Seat 2: RAZOR99999 (button) folded before Flop (didn't bet)
Seat 3: bazman125 (small blind) collected ($3.80)
Seat 4: reynaldo1244 (big blind) folded on the Flop
Seat 5: mrdust1 folded before Flop (didn't bet)
Seat 6: Mab471 folded before Flop (didn't bet)


PokerStars Hand #232993377654:  Hold'em No Limit ($1/$2 USD) - 2022/01/16 14:09:12 ET
Table 'Atalante' 6-max Seat #3 is the button
Seat 1: MiltonBradley ($203 in chips)
Seat 2: RAZOR99999 ($57.11 in chips)
Seat 3: bazman125 ($311.48 in chips)
Seat 4: reynaldo1244 ($200 in chips)
Seat 5: mrdust1 ($336.05 in chips)
Seat 6: Mab471 ($200 in chips)
reynaldo1244: posts small blind $1
mrdust1: posts big blind $2
*** HOLE CARDS ***
Mab471: folds
MiltonBradley: folds
RAZOR99999: folds
bazman125: folds
reynaldo1244: folds
Uncalled bet ($1) returned to mrdust1
mrdust1 collected $2 from pot
mrdust1: doesn't show hand
*** SUMMARY ***
Total pot $2 | Rake $0
Seat 1: MiltonBradley folded before Flop (didn't bet)
Seat 2: RAZOR99999 folded before Flop (didn't bet)
Seat 3: bazman125 (button) folded before Flop (didn't bet)
Seat 4: reynaldo1244 (small blind) folded before Flop
Seat 5: mrdust1 (big blind) collected ($2)
Seat 6: Mab471 folded before Flop (didn't bet)


PokerStars Hand #232993377716:  Hold'em No Limit ($1/$2 USD) - 2022/01/16 14:09:22 ET
Table 'Atalante' 6-max Seat #4 is the button
Seat 1: MiltonBradley ($203 in chips)
Seat 2: RAZOR99999 ($57.11 in chips)
Seat 3: bazman125 ($311.48 in chips)
Seat 4: reynaldo1244 ($200 in chips)
Seat 5: mrdust1 ($337.05 in chips)
Seat 6: Mab471 ($200 in chips)
mrdust1: posts small blind $1
Mab471: posts big blind $2
*** HOLE CARDS ***
MiltonBradley: raises $2.42 to $4.42
RAZOR99999: folds
bazman125: folds
reynaldo1244: folds
mrdust1: folds
Mab471: calls $2.42
*** FLOP *** [6s Ad 7d]
Mab471: checks
MiltonBradley: bets $3.18
Mab471: calls $3.18
*** TURN *** [6s Ad 7d] [8h]
Mab471: checks
MiltonBradley: checks
*** RIVER *** [6s Ad 7d 8h] [9c]
Mab471: checks
MiltonBradley: bets $8
Mab471: folds
Uncalled bet ($8) returned to MiltonBradley
MiltonBradley collected $15.39 from pot
MiltonBradley: doesn't show hand
*** SUMMARY ***
Total pot $16.20 | Rake $0.81
Board [6s Ad 7d 8h 9c]
Seat 1: MiltonBradley collected ($15.39)
Seat 2: RAZOR99999 folded before Flop (didn't bet)
Seat 3: bazman125 folded before Flop (didn't bet)
Seat 4: reynaldo1244 (button) folded before Flop (didn't bet)
Seat 5: mrdust1 (small blind) folded before Flop
Seat 6: Mab471 (big blind) folded on the River


PokerStars Hand #232993378238:  Hold'em No Limit ($1/$2 USD) - 2022/01/16 14:10:43 ET
Table 'Atalante' 6-max Seat #5 is the button
Seat 1: MiltonBradley ($210.79 in chips)
Seat 2: RAZOR99999 ($57.11 in chips)
Seat 3: bazman125 ($311.48 in chips)
Seat 4: reynaldo1244 ($200 in chips)
Seat 5: mrdust1 ($336.05 in chips)
Seat 6: Mab471 ($200 in chips)
Mab471: posts small blind $1
MiltonBradley: posts big blind $2
*** HOLE CARDS ***
RAZOR99999: folds
bazman125: folds
reynaldo1244: folds
mrdust1: raises $3 to $5
Mab471: folds
MiltonBradley: calls $3
*** FLOP *** [7c Jd 2s]
MiltonBradley: checks
mrdust1: checks
*** TURN *** [7c Jd 2s] [Ks]
MiltonBradley: checks
mrdust1: bets $4.60
MiltonBradley: folds
Uncalled bet ($4.60) returned to mrdust1
mrdust1 collected $10.45 from pot
mrdust1: doesn't show hand
*** SUMMARY ***
Total pot $11 | Rake $0.55
Board [7c Jd 2s Ks]
Seat 1: MiltonBradley (big blind) folded on the Turn
Seat 2: RAZOR99999 folded before Flop (didn't bet)
Seat 3: bazman125 folded before Flop (didn't bet)
Seat 4: reynaldo1244 folded before Flop (didn't bet)
Seat 5: mrdust1 (button) collected ($10.45)
Seat 6: Mab471 (small blind) folded before Flop


PokerStars Hand #232993378653:  Hold'em No Limit ($1/$2 USD) - 2022/01/16 14:11:41 ET
Table 'Atalante' 6-max Seat #6 is the button
Seat 1: MiltonBradley ($205.79 in chips)
Seat 2: RAZOR99999 ($57.11 in chips)
Seat 3: bazman125 ($311.48 in chips)
Seat 4: reynaldo1244 ($200 in chips)
Seat 5: mrdust1 ($341.50 in chips)
Seat 6: Mab471 ($200 in chips)
MiltonBradley: posts small blind $1
RAZOR99999: posts big blind $2
*** HOLE CARDS ***
bazman125 has timed out
bazman125: folds
reynaldo1244: raises $3 to $5
mrdust1: folds
Mab471: folds
MiltonBradley: folds
RAZOR99999: folds
Uncalled bet ($3) returned to reynaldo1244
reynaldo1244 collected $5 from pot
reynaldo1244: doesn't show hand
*** SUMMARY ***
Total pot $5 | Rake $0
Seat 1: MiltonBradley (small blind) folded before Flop
Seat 2: RAZOR99999 (big blind) folded before Flop
Seat 3: bazman125 folded before Flop (didn't bet)
Seat 4: reynaldo1244 collected ($5)
Seat 5: mrdust1 folded before Flop (didn't bet)
Seat 6: Mab471 (button) folded before Flop (didn't bet)


PokerStars Hand #232993378907:  Hold'em No Limit ($1/$2 USD) - 2022/01/16 14:12:21 ET
Table 'Atalante' 6-max Seat #1 is the button
Seat 1: MiltonBradley ($204.79 in chips)
Seat 2: RAZOR99999 ($55.11 in chips)
Seat 4: reynaldo1244 ($203 in chips)
Seat 5: mrdust1 ($341.50 in chips)
Seat 6: Mab471 ($200 in chips)
RAZOR99999: posts small blind $1
reynaldo1244: posts big blind $2
*** HOLE CARDS ***
mrdust1: folds
Mab471: folds
MiltonBradley: folds
RAZOR99999: folds
Uncalled bet ($1) returned to reynaldo1244
reynaldo1244 collected $2 from pot
reynaldo1244: doesn't show hand
*** SUMMARY ***
Total pot $2 | Rake $0
Seat 1: MiltonBradley (button) folded before Flop (didn't bet)
Seat 2: RAZOR99999 (small blind) folded before Flop
Seat 4: reynaldo1244 (big blind) collected ($2)
Seat 5: mrdust1 folded before Flop (didn't bet)
Seat 6: Mab471 folded before Flop (didn't bet)


PokerStars Hand #232993378980:  Hold'em No Limit ($1/$2 USD) - 2022/01/16 14:12:31 ET
Table 'Atalante' 6-max Seat #2 is the button
Seat 1: MiltonBradley ($204.79 in chips)
Seat 2: RAZOR99999 ($54.11 in chips)
Seat 4: reynaldo1244 ($204 in chips)
Seat 5: mrdust1 ($341.50 in chips)
Seat 6: Mab471 ($200 in chips)
reynaldo1244: posts small blind $1
mrdust1: posts big blind $2
*** HOLE CARDS ***
Mab471: raises $2.40 to $4.40
MiltonBradley: folds
RAZOR99999: folds
reynaldo1244: folds
mrdust1: calls $2.40
*** FLOP *** [Kh Ts 9h]
mrdust1: checks
Mab471: checks
*** TURN *** [Kh Ts 9h] [8d]
mrdust1: checks
Mab471: checks
*** RIVER *** [Kh Ts 9h 8d] [Qh]
mrdust1: bets $4.10
Mab471: folds
Uncalled bet ($4.10) returned to mrdust1
mrdust1 collected $9.31 from pot
mrdust1: doesn't show hand
*** SUMMARY ***
Total pot $9.80 | Rake $0.49
Board [Kh Ts 9h 8d Qh]
Seat 1: MiltonBradley folded before Flop (didn't bet)
Seat 2: RAZOR99999 (button) folded before Flop (didn't bet)
Seat 4: reynaldo1244 (small blind) folded before Flop
Seat 5: mrdust1 (big blind) collected ($9.31)
Seat 6: Mab471 folded on the River


PokerStars Hand #232993379502:  Hold'em No Limit ($1/$2 USD) - 2022/01/16 14:13:49 ET
Table 'Atalante' 6-max Seat #4 is the button
Seat 1: MiltonBradley ($204.79 in chips)
Seat 2: RAZOR99999 ($54.11 in chips)
Seat 4: reynaldo1244 ($203 in chips)
Seat 5: mrdust1 ($346.41 in chips)
Seat 6: Mab471 ($200 in chips)
mrdust1: posts small blind $1
Mab471: posts big blind $2
*** HOLE CARDS ***
MiltonBradley: folds
RAZOR99999: folds
reynaldo1244: raises $3 to $5
mrdust1: folds
Mab471: folds
Uncalled bet ($3) returned to reynaldo1244
reynaldo1244 collected $5 from pot
reynaldo1244: doesn't show hand
*** SUMMARY ***
Total pot $5 | Rake $0
Seat 1: MiltonBradley folded before Flop (didn't bet)
Seat 2: RAZOR99999 folded before Flop (didn't bet)
Seat 4: reynaldo1244 (button) collected ($5)
Seat 5: mrdust1 (small blind) folded before Flop
Seat 6: Mab471 (big blind) folded before Flop


PokerStars Hand #232993379645:  Hold'em No Limit ($1/$2 USD) - 2022/01/16 14:14:09 ET
Table 'Atalante' 6-max Seat #5 is the button
Seat 1: MiltonBradley ($204.79 in chips)
Seat 2: RAZOR99999 ($54.11 in chips)
Seat 4: reynaldo1244 ($206 in chips)
Seat 5: mrdust1 ($345.41 in chips)
Seat 6: Mab471 ($200 in chips)
Mab471: posts small blind $1
MiltonBradley: posts big blind $2
*** HOLE CARDS ***
RAZOR99999: raises $4 to $6
reynaldo1244: folds
mrdust1: folds
Mab471: folds
MiltonBradley: folds
Uncalled bet ($4) returned to RAZOR99999
RAZOR99999 collected $5 from pot
RAZOR99999: doesn't show hand
*** SUMMARY ***
Total pot $5 | Rake $0
Seat 1: MiltonBradley (big blind) folded before Flop
Seat 2: RAZOR99999 collected ($5)
Seat 4: reynaldo1244 folded before Flop (didn't bet)
Seat 5: mrdust1 (button) folded before Flop (didn't bet)
Seat 6: Mab471 (small blind) folded before Flop


PokerStars Hand #232993379775:  Hold'em No Limit ($1/$2 USD) - 2022/01/16 14:14:29 ET
Table 'Atalante' 6-max Seat #6 is the button
Seat 1: MiltonBradley ($202.79 in chips)
Seat 2: RAZOR99999 ($57.11 in chips)
Seat 4: reynaldo1244 ($206 in chips)
Seat 5: mrdust1 ($345.41 in chips)
Seat 6: Mab471 ($200 in chips)
MiltonBradley: posts small blind $1
RAZOR99999: posts big blind $2
bazman125: sits out
*** HOLE CARDS ***
reynaldo1244: folds
mrdust1: folds
Mab471: raises $3 to $5
MiltonBradley: folds
RAZOR99999: folds
Uncalled bet ($3) returned to Mab471
Mab471 collected $5 from pot
Mab471: doesn't show hand
*** SUMMARY ***
Total pot $5 | Rake $0
Seat 1: MiltonBradley (small blind) folded before Flop
Seat 2: RAZOR99999 (big blind) folded before Flop
Seat 4: reynaldo1244 folded before Flop (didn't bet)
Seat 5: mrdust1 folded before Flop (didn't bet)
Seat 6: Mab471 (button) collected ($5)


PokerStars Hand #232993379863:  Hold'em No Limit ($1/$2 USD) - 2022/01/16 14:14:43 ET
Table 'Atalante' 6-max Seat #1 is the button
Seat 1: MiltonBradley ($201.79 in chips)
Seat 2: RAZOR99999 ($55.11 in chips)
Seat 3: bazman125 ($311.48 in chips)
Seat 4: reynaldo1244 ($206 in chips)
Seat 5: mrdust1 ($345.41 in chips)
Seat 6: Mab471 ($203 in chips)
RAZOR99999: posts small blind $1
bazman125: posts big blind $2
*** HOLE CARDS ***
reynaldo1244: folds
mrdust1: folds
Mab471: folds
MiltonBradley: folds
RAZOR99999: folds
Uncalled bet ($1) returned to bazman125
bazman125 collected $2 from pot
*** SUMMARY ***
Total pot $2 | Rake $0
Seat 1: MiltonBradley (button) folded before Flop (didn't bet)
Seat 2: RAZOR99999 (small blind) folded before Flop
Seat 3: bazman125 (big blind) collected ($2)
Seat 4: reynaldo1244 folded before Flop (didn't bet)
Seat 5: mrdust1 folded before Flop (didn't bet)
Seat 6: Mab471 folded before Flop (didn't bet)


PokerStars Hand #232993379937:  Hold'em No Limit ($1/$2 USD) - 2022/01/16 14:14:56 ET
Table 'Atalante' 6-max Seat #2 is the button
Seat 1: MiltonBradley ($201.79 in chips)
Seat 2: RAZOR99999 ($54.11 in chips)
Seat 3: bazman125 ($312.48 in chips)
Seat 4: reynaldo1244 ($206 in chips)
Seat 5: mrdust1 ($345.41 in chips)
Seat 6: Mab471 ($203 in chips)
bazman125: posts small blind $1
reynaldo1244: posts big blind $2
*** HOLE CARDS ***
mrdust1: raises $3 to $5
Mab471: folds
MiltonBradley: folds
RAZOR99999: folds
bazman125: folds
reynaldo1244: folds
Uncalled bet ($3) returned to mrdust1
mrdust1 collected $5 from pot
mrdust1: doesn't show hand
*** SUMMARY ***
Total pot $5 | Rake $0
Seat 1: MiltonBradley folded before Flop (didn't bet)
Seat 2: RAZOR99999 (button) folded before Flop (didn't bet)
Seat 3: bazman125 (small blind) folded before Flop
Seat 4: reynaldo1244 (big blind) folded before Flop
Seat 5: mrdust1 collected ($5)
Seat 6: Mab471 folded before Flop (didn't bet)


PokerStars Hand #232993628939:  Hold'em No Limit ($1/$2 USD) - 2022/01/16 14:15:12 ET
Table 'Atalante' 6-max Seat #3 is the button
Seat 1: MiltonBradley ($201.79 in chips)
Seat 2: RAZOR99999 ($54.11 in chips)
Seat 3: bazman125 ($311.48 in chips)
Seat 4: reynaldo1244 ($204 in chips)
Seat 5: mrdust1 ($348.41 in chips)
Seat 6: Mab471 ($203 in chips)
reynaldo1244: posts small blind $1
mrdust1: posts big blind $2
*** HOLE CARDS ***
Mab471: raises $2.40 to $4.40
MiltonBradley: folds
RAZOR99999: folds
bazman125: folds
reynaldo1244: raises $15.60 to $20
mrdust1: folds
Mab471: calls $15.60
*** FLOP *** [Qh 4s 2d]
reynaldo1244: bets $16
Mab471: folds
Uncalled bet ($16) returned to reynaldo1244
reynaldo1244 collected $39.90 from pot
reynaldo1244: doesn't show hand
*** SUMMARY ***
Total pot $42 | Rake $2.10
Board [Qh 4s 2d]
Seat 1: MiltonBradley folded before Flop (didn't bet)
Seat 2: RAZOR99999 folded before Flop (didn't bet)
Seat 3: bazman125 (button) folded before Flop (didn't bet)
Seat 4: reynaldo1244 (small blind) collected ($39.90)
Seat 5: mrdust1 (big blind) folded before Flop
Seat 6: Mab471 folded on the Flop


PokerStars Hand #232993629305:  Hold'em No Limit ($1/$2 USD) - 2022/01/16 14:16:11 ET
Table 'Atalante' 6-max Seat #4 is the button
Seat 1: MiltonBradley ($201.79 in chips)
Seat 2: RAZOR99999 ($54.11 in chips)
Seat 3: bazman125 ($311.48 in chips)
Seat 4: reynaldo1244 ($223.90 in chips)
Seat 5: mrdust1 ($346.41 in chips)
Seat 6: Mab471 ($200 in chips)
mrdust1: posts small blind $1
Mab471: posts big blind $2
*** HOLE CARDS ***
MiltonBradley: folds
RAZOR99999: folds
bazman125: calls $2
reynaldo1244: folds
mrdust1: folds
Mab471: checks
*** FLOP *** [9c 3d Th]
Mab471: checks
bazman125: bets $2
Mab471: folds
Uncalled bet ($2) returned to bazman125
bazman125 collected $4.75 from pot
*** SUMMARY ***
Total pot $5 | Rake $0.25
Board [9c 3d Th]
Seat 1: MiltonBradley folded before Flop (didn't bet)
Seat 2: RAZOR99999 folded before Flop (didn't bet)
Seat 3: bazman125 collected ($4.75)
Seat 4: reynaldo1244 (button) folded before Flop (didn't bet)
Seat 5: mrdust1 (small blind) folded before Flop
Seat 6: Mab471 (big blind) folded on the Flop


PokerStars Hand #232993629535:  Hold'em No Limit ($1/$2 USD) - 2022/01/16 14:16:51 ET
Table 'Atalante' 6-max Seat #5 is the button
Seat 1: MiltonBradley ($201.79 in chips)
Seat 2: RAZOR99999 ($54.11 in chips)
Seat 3: bazman125 ($314.23 in chips)
Seat 4: reynaldo1244 ($223.90 in chips)
Seat 5: mrdust1 ($345.41 in chips)
Seat 6: Mab471 ($200 in chips)
Mab471: posts small blind $1
MiltonBradley: posts big blind $2
*** HOLE CARDS ***
RAZOR99999: folds
bazman125: folds
reynaldo1244: folds
mrdust1: folds
Mab471: folds
Uncalled bet ($1) returned to MiltonBradley
MiltonBradley collected $2 from pot
MiltonBradley: doesn't show hand
*** SUMMARY ***
Total pot $2 | Rake $0
Seat 1: MiltonBradley (big blind) collected ($2)
Seat 2: RAZOR99999 folded before Flop (didn't bet)
Seat 3: bazman125 folded before Flop (didn't bet)
Seat 4: reynaldo1244 folded before Flop (didn't bet)
Seat 5: mrdust1 (button) folded before Flop (didn't bet)
Seat 6: Mab471 (small blind) folded before Flop


PokerStars Hand #232993629608:  Hold'em No Limit ($1/$2 USD) - 2022/01/16 14:17:02 ET
Table 'Atalante' 6-max Seat #6 is the button
Seat 1: MiltonBradley ($202.79 in chips)
Seat 2: RAZOR99999 ($54.11 in chips)
Seat 3: bazman125 ($314.23 in chips)
Seat 4: reynaldo1244 ($223.90 in chips)
Seat 5: mrdust1 ($345.41 in chips)
Seat 6: Mab471 ($200 in chips)
MiltonBradley: posts small blind $1
RAZOR99999: posts big blind $2
*** HOLE CARDS ***
bazman125: calls $2
reynaldo1244: folds
mrdust1: folds
Mab471: folds
MiltonBradley: folds
RAZOR99999: checks
*** FLOP *** [2d 9c 6h]
RAZOR99999: checks
bazman125: bets $2
RAZOR99999: calls $2
*** TURN *** [2d 9c 6h] [As]
RAZOR99999: bets $5
bazman125: calls $5
*** RIVER *** [2d 9c 6h As] [6d]
RAZOR99999: checks
bazman125: checks
*** SHOW DOWN ***
RAZOR99999: shows [9s Td] (two pair, Nines and Sixes)
bazman125: shows [4h Ah] (two pair, Aces and Sixes)
bazman125 collected $18.05 from pot
*** SUMMARY ***
Total pot $19 | Rake $0.95
Board [2d 9c 6h As 6d]
Seat 1: MiltonBradley (small blind) folded before Flop
Seat 2: RAZOR99999 (big blind) showed [9s Td] and lost with two pair, Nines and Sixes
Seat 3: bazman125 showed [4h Ah] and won ($18.05) with two pair, Aces and Sixes
Seat 4: reynaldo1244 folded before Flop (didn't bet)
Seat 5: mrdust1 folded before Flop (didn't bet)
Seat 6: Mab471 (button) folded before Flop (didn't bet)


PokerStars Hand #232993629844:  Hold'em No Limit ($1/$2 USD) - 2022/01/16 14:17:40 ET
Table 'Atalante' 6-max Seat #1 is the button
Seat 1: MiltonBradley ($201.79 in chips)
Seat 2: RAZOR99999 ($45.11 in chips)
Seat 3: bazman125 ($323.28 in chips)
Seat 4: reynaldo1244 ($223.90 in chips)
Seat 5: mrdust1 ($345.41 in chips)
Seat 6: Mab471 ($200 in chips)
RAZOR99999: posts small blind $1
bazman125: posts big blind $2
*** HOLE CARDS ***
reynaldo1244: raises $3 to $5
mrdust1: folds
Mab471: folds
MiltonBradley: folds
RAZOR99999: folds
bazman125: calls $3
*** FLOP *** [8s 6c 3d]
bazman125: bets $2
reynaldo1244: raises $8 to $10
bazman125: folds [8d]
Uncalled bet ($8) returned to reynaldo1244
reynaldo1244 collected $14.25 from pot
reynaldo1244: doesn't show hand
*** SUMMARY ***
Total pot $15 | Rake $0.75
Board [8s 6c 3d]
Seat 1: MiltonBradley (button) folded before Flop (didn't bet)
Seat 2: RAZOR99999 (small blind) folded before Flop
Seat 3: bazman125 (big blind) folded on the Flop
Seat 4: reynaldo1244 collected ($14.25)
Seat 5: mrdust1 folded before Flop (didn't bet)
Seat 6: Mab471 folded before Flop (didn't bet)


PokerStars Hand #232993659267:  Hold'em No Limit ($1/$2 USD) - 2022/01/16 14:18:28 ET
Table 'Atalante' 6-max Seat #2 is the button
Seat 1: MiltonBradley ($201.79 in chips)
Seat 2: RAZOR99999 ($44.11 in chips)
Seat 3: bazman125 ($316.28 in chips)
Seat 4: reynaldo1244 ($231.15 in chips)
Seat 5: mrdust1 ($345.41 in chips)
Seat 6: Mab471 ($200 in chips)
bazman125: posts small blind $1
reynaldo1244: posts big blind $2
*** HOLE CARDS ***
mrdust1: folds
Mab471: folds
MiltonBradley: folds
RAZOR99999: folds
bazman125: folds
Uncalled bet ($1) returned to reynaldo1244
reynaldo1244 collected $2 from pot
reynaldo1244: doesn't show hand
*** SUMMARY ***
Total pot $2 | Rake $0
Seat 1: MiltonBradley folded before Flop (didn't bet)
Seat 2: RAZOR99999 (button) folded before Flop (didn't bet)
Seat 3: bazman125 (small blind) folded before Flop
Seat 4: reynaldo1244 (big blind) collected ($2)
Seat 5: mrdust1 folded before Flop (didn't bet)
Seat 6: Mab471 folded before Flop (didn't bet)


PokerStars Hand #232993659390:  Hold'em No Limit ($1/$2 USD) - 2022/01/16 14:18:49 ET
Table 'Atalante' 6-max Seat #3 is the button
Seat 1: MiltonBradley ($201.79 in chips)
Seat 2: RAZOR99999 ($44.11 in chips)
Seat 3: bazman125 ($315.28 in chips)
Seat 4: reynaldo1244 ($232.15 in chips)
Seat 5: mrdust1 ($345.41 in chips)
Seat 6: Mab471 ($200 in chips)
reynaldo1244: posts small blind $1
mrdust1: posts big blind $2
*** HOLE CARDS ***
Mab471: folds
MiltonBradley: folds
RAZOR99999: folds
bazman125: calls $2
reynaldo1244: folds
mrdust1: checks
*** FLOP *** [5s 8s 3h]
mrdust1: checks
bazman125: checks
*** TURN *** [5s 8s 3h] [Qs]
mrdust1: bets $4
bazman125: calls $4
*** RIVER *** [5s 8s 3h Qs] [4s]
mrdust1: checks
bazman125: checks
*** SHOW DOWN ***
mrdust1: shows [2s 4c] (a flush, Queen high)
bazman125: shows [Ts 9h] (a flush, Queen high - Ten higher)
bazman125 collected $12.35 from pot
*** SUMMARY ***
Total pot $13 | Rake $0.65
Board [5s 8s 3h Qs 4s]
Seat 1: MiltonBradley folded before Flop (didn't bet)
Seat 2: RAZOR99999 folded before Flop (didn't bet)
Seat 3: bazman125 (button) showed [Ts 9h] and won ($12.35) with a flush, Queen high
Seat 4: reynaldo1244 (small blind) folded before Flop
Seat 5: mrdust1 (big blind) showed [2s 4c] and lost with a flush, Queen high
Seat 6: Mab471 folded before Flop (didn't bet)


PokerStars Hand #232993659734:  Hold'em No Limit ($1/$2 USD) - 2022/01/16 14:19:45 ET
Table 'Atalante' 6-max Seat #4 is the button
Seat 1: MiltonBradley ($201.79 in chips)
Seat 2: RAZOR99999 ($44.11 in chips)
Seat 3: bazman125 ($321.63 in chips)
Seat 4: reynaldo1244 ($231.15 in chips)
Seat 5: mrdust1 ($339.41 in chips)
Seat 6: Mab471 ($200 in chips)
mrdust1: posts small blind $1
Mab471: posts big blind $2
*** HOLE CARDS ***
MiltonBradley: folds
RAZOR99999: folds
bazman125: folds
reynaldo1244: folds
mrdust1: folds
Uncalled bet ($1) returned to Mab471
Mab471 collected $2 from pot
Mab471: doesn't show hand
*** SUMMARY ***
Total pot $2 | Rake $0
Seat 1: MiltonBradley folded before Flop (didn't bet)
Seat 2: RAZOR99999 folded before Flop (didn't bet)
Seat 3: bazman125 folded before Flop (didn't bet)
Seat 4: reynaldo1244 (button) folded before Flop (didn't bet)
Seat 5: mrdust1 (small blind) folded before Flop
Seat 6: Mab471 (big blind) collected ($2)


PokerStars Hand #232993659849:  Hold'em No Limit ($1/$2 USD) - 2022/01/16 14:20:04 ET
Table 'Atalante' 6-max Seat #5 is the button
Seat 1: MiltonBradley ($201.79 in chips)
Seat 2: RAZOR99999 ($44.11 in chips)
Seat 3: bazman125 ($321.63 in chips)
Seat 4: reynaldo1244 ($231.15 in chips)
Seat 5: mrdust1 ($338.41 in chips)
Seat 6: Mab471 ($201 in chips)
Mab471: posts small blind $1
MiltonBradley: posts big blind $2
*** HOLE CARDS ***
RAZOR99999: folds
bazman125: calls $2
reynaldo1244: folds
mrdust1: folds
Mab471: calls $1
MiltonBradley: checks
*** FLOP *** [3d As Qh]
Mab471: checks
MiltonBradley: checks
bazman125: bets $5.70
Mab471: calls $5.70
MiltonBradley: folds
*** TURN *** [3d As Qh] [Ad]
Mab471: checks
bazman125: bets $8.27
Mab471: calls $8.27
*** RIVER *** [3d As Qh Ad] [Jd]
Mab471: checks
bazman125: bets $16.12
Mab471: folds
Uncalled bet ($16.12) returned to bazman125
bazman125 collected $32.24 from pot
*** SUMMARY ***
Total pot $33.94 | Rake $1.70
Board [3d As Qh Ad Jd]
Seat 1: MiltonBradley (big blind) folded on the Flop
Seat 2: RAZOR99999 folded before Flop (didn't bet)
Seat 3: bazman125 collected ($32.24)
Seat 4: reynaldo1244 folded before Flop (didn't bet)
Seat 5: mrdust1 (button) folded before Flop (didn't bet)
Seat 6: Mab471 (small blind) folded on the River


PokerStars Hand #232993685644:  Hold'em No Limit ($1/$2 USD) - 2022/01/16 14:21:21 ET
Table 'Atalante' 6-max Seat #6 is the button
Seat 1: MiltonBradley ($200 in chips)
Seat 2: RAZOR99999 ($44.11 in chips)
Seat 3: bazman125 ($337.90 in chips)
Seat 4: reynaldo1244 ($231.15 in chips)
Seat 5: mrdust1 ($338.41 in chips)
Seat 6: Mab471 ($200 in chips)
MiltonBradley: posts small blind $1
RAZOR99999: posts big blind $2
*** HOLE CARDS ***
bazman125: folds
reynaldo1244: folds
mrdust1: folds
Mab471: folds
MiltonBradley: folds
Uncalled bet ($1) returned to RAZOR99999
RAZOR99999 collected $2 from pot
RAZOR99999: doesn't show hand
*** SUMMARY ***
Total pot $2 | Rake $0
Seat 1: MiltonBradley (small blind) folded before Flop
Seat 2: RAZOR99999 (big blind) collected ($2)
Seat 3: bazman125 folded before Flop (didn't bet)
Seat 4: reynaldo1244 folded before Flop (didn't bet)
Seat 5: mrdust1 folded before Flop (didn't bet)
Seat 6: Mab471 (button) folded before Flop (didn't bet)


PokerStars Hand #232993685750:  Hold'em No Limit ($1/$2 USD) - 2022/01/16 14:21:38 ET
Table 'Atalante' 6-max Seat #1 is the button
Seat 1: MiltonBradley ($200 in chips)
Seat 2: RAZOR99999 ($45.11 in chips)
Seat 3: bazman125 ($337.90 in chips)
Seat 4: reynaldo1244 ($231.15 in chips)
Seat 5: mrdust1 ($338.41 in chips)
Seat 6: Mab471 ($200 in chips)
RAZOR99999: posts small blind $1
bazman125: posts big blind $2
*** HOLE CARDS ***
reynaldo1244: folds
mrdust1: folds
Mab471: folds
MiltonBradley: folds
RAZOR99999: raises $6 to $8
bazman125: folds
Uncalled bet ($6) returned to RAZOR99999
RAZOR99999 collected $4 from pot
RAZOR99999: doesn't show hand
*** SUMMARY ***
Total pot $4 | Rake $0
Seat 1: MiltonBradley (button) folded before Flop (didn't bet)
Seat 2: RAZOR99999 (small blind) collected ($4)
Seat 3: bazman125 (big blind) folded before Flop
Seat 4: reynaldo1244 folded before Flop (didn't bet)
Seat 5: mrdust1 folded before Flop (didn't bet)
Seat 6: Mab471 folded before Flop (didn't bet)


PokerStars Hand #232993685893:  Hold'em No Limit ($1/$2 USD) - 2022/01/16 14:22:02 ET
Table 'Atalante' 6-max Seat #2 is the button
Seat 1: MiltonBradley ($200 in chips)
Seat 2: RAZOR99999 ($47.11 in chips)
Seat 3: bazman125 ($335.90 in chips)
Seat 4: reynaldo1244 ($231.15 in chips)
Seat 5: mrdust1 ($338.41 in chips)
Seat 6: Mab471 ($200 in chips)
bazman125: posts small blind $1
reynaldo1244: posts big blind $2
*** HOLE CARDS ***
mrdust1: raises $3 to $5
Mab471: folds
MiltonBradley: folds
RAZOR99999: folds
bazman125: folds
reynaldo1244: folds
Uncalled bet ($3) returned to mrdust1
mrdust1 collected $5 from pot
mrdust1: doesn't show hand
*** SUMMARY ***
Total pot $5 | Rake $0
Seat 1: MiltonBradley folded before Flop (didn't bet)
Seat 2: RAZOR99999 (button) folded before Flop (didn't bet)
Seat 3: bazman125 (small blind) folded before Flop
Seat 4: reynaldo1244 (big blind) folded before Flop
Seat 5: mrdust1 collected ($5)
Seat 6: Mab471 folded before Flop (didn't bet)


PokerStars Hand #232993685983:  Hold'em No Limit ($1/$2 USD) - 2022/01/16 14:22:15 ET
Table 'Atalante' 6-max Seat #3 is the button
Seat 1: MiltonBradley ($200 in chips)
Seat 2: RAZOR99999 ($47.11 in chips)
Seat 3: bazman125 ($334.90 in chips)
Seat 4: reynaldo1244 ($229.15 in chips)
Seat 5: mrdust1 ($341.41 in chips)
Seat 6: Mab471 ($200 in chips)
reynaldo1244: posts small blind $1
mrdust1: posts big blind $2
*** HOLE CARDS ***
Mab471: folds
MiltonBradley: raises $3.02 to $5.02
RAZOR99999: folds
bazman125: raises $8.98 to $14
reynaldo1244: folds
mrdust1: folds
MiltonBradley: calls $8.98
*** FLOP *** [Qc 8c 3d]
MiltonBradley: checks
bazman125: bets $14.73
MiltonBradley: folds
Uncalled bet ($14.73) returned to bazman125
bazman125 collected $29.45 from pot
*** SUMMARY ***
Total pot $31 | Rake $1.55
Board [Qc 8c 3d]
Seat 1: MiltonBradley folded on the Flop
Seat 2: RAZOR99999 folded before Flop (didn't bet)
Seat 3: bazman125 (button) collected ($29.45)
Seat 4: reynaldo1244 (small blind) folded before Flop
Seat 5: mrdust1 (big blind) folded before Flop
Seat 6: Mab471 folded before Flop (didn't bet)


PokerStars Hand #232993686330:  Hold'em No Limit ($1/$2 USD) - 2022/01/16 14:23:09 ET
Table 'Atalante' 6-max Seat #4 is the button
Seat 1: MiltonBradley ($200 in chips)
Seat 2: RAZOR99999 ($47.11 in chips)
Seat 3: bazman125 ($350.35 in chips)
Seat 4: reynaldo1244 ($228.15 in chips)
Seat 5: mrdust1 ($339.41 in chips)
Seat 6: Mab471 ($200 in chips)
mrdust1: posts small blind $1
Mab471: posts big blind $2
*** HOLE CARDS ***
MiltonBradley: raises $2.42 to $4.42
RAZOR99999: folds
bazman125: folds
reynaldo1244: raises $11.58 to $16
mrdust1: folds
Mab471: folds
MiltonBradley: folds
Uncalled bet ($11.58) returned to reynaldo1244
reynaldo1244 collected $11.84 from pot
reynaldo1244: doesn't show hand
*** SUMMARY ***
Total pot $11.84 | Rake $0
Seat 1: MiltonBradley folded before Flop
Seat 2: RAZOR99999 folded before Flop (didn't bet)
Seat 3: bazman125 folded before Flop (didn't bet)
Seat 4: reynaldo1244 (button) collected ($11.84)
Seat 5: mrdust1 (small blind) folded before Flop
Seat 6: Mab471 (big blind) folded before Flop


PokerStars Hand #232993686462:  Hold'em No Limit ($1/$2 USD) - 2022/01/16 14:23:28 ET
Table 'Atalante' 6-max Seat #5 is the button
Seat 1: MiltonBradley ($200 in chips)
Seat 2: RAZOR99999 ($47.11 in chips)
Seat 3: bazman125 ($350.35 in chips)
Seat 4: reynaldo1244 ($235.57 in chips)
Seat 5: mrdust1 ($338.41 in chips)
Seat 6: Mab471 ($200 in chips)
Mab471: posts small blind $1
MiltonBradley: posts big blind $2
*** HOLE CARDS ***
RAZOR99999: raises $5 to $7
bazman125: folds
reynaldo1244: raises $9 to $16
mrdust1: folds
Mab471: folds
MiltonBradley: raises $26.80 to $42.80
RAZOR99999: raises $4.31 to $47.11 and is all-in
reynaldo1244: calls $31.11
MiltonBradley: calls $4.31
*** FLOP *** [6s Ah Qh]
MiltonBradley: checks
reynaldo1244: checks
*** TURN *** [6s Ah Qh] [5h]
MiltonBradley: checks
reynaldo1244: bets $188.46 and is all-in
MiltonBradley: folds
Uncalled bet ($188.46) returned to reynaldo1244
*** FIRST RIVER *** [6s Ah Qh 5h] [4s]
*** SECOND RIVER *** [6s Ah Qh 5h] [3c]
*** FIRST SHOW DOWN ***
RAZOR99999: shows [Tc Ts] (a pair of Tens)
reynaldo1244: shows [Ad Ac] (three of a kind, Aces)
reynaldo1244 collected $69.67 from pot
*** SECOND SHOW DOWN ***
RAZOR99999: shows [Tc Ts] (a pair of Tens)
reynaldo1244: shows [Ad Ac] (three of a kind, Aces)
reynaldo1244 collected $69.66 from pot
*** SUMMARY ***
Total pot $142.33 | Rake $3
Hand was run twice
FIRST Board [6s Ah Qh 5h 4s]
SECOND Board [6s Ah Qh 5h 3c]
Seat 1: MiltonBradley (big blind) folded on the Turn
Seat 2: RAZOR99999 showed [Tc Ts] and lost with a pair of Tens, and lost with a pair of Tens
Seat 3: bazman125 folded before Flop (didn't bet)
Seat 4: reynaldo1244 showed [Ad Ac] and won ($69.67) with three of a kind, Aces, and won ($69.66) with three of a kind, Aces
Seat 5: mrdust1 (button) folded before Flop (didn't bet)
Seat 6: Mab471 (small blind) folded before Flop


PokerStars Hand #232993686946:  Hold'em No Limit ($1/$2 USD) - 2022/01/16 14:24:40 ET
Table 'Atalante' 6-max Seat #6 is the button
Seat 1: MiltonBradley ($200 in chips)
Seat 3: bazman125 ($350.35 in chips)
Seat 4: reynaldo1244 ($327.79 in chips)
Seat 5: mrdust1 ($338.41 in chips)
Seat 6: Mab471 ($200 in chips)
MiltonBradley: posts small blind $1
bazman125: posts big blind $2
*** HOLE CARDS ***
reynaldo1244: folds
mrdust1: folds
Mab471: raises $3 to $5
MiltonBradley: folds
bazman125: folds
Uncalled bet ($3) returned to Mab471
Mab471 collected $5 from pot
Mab471: doesn't show hand
*** SUMMARY ***
Total pot $5 | Rake $0
Seat 1: MiltonBradley (small blind) folded before Flop
Seat 3: bazman125 (big blind) folded before Flop
Seat 4: reynaldo1244 folded before Flop (didn't bet)
Seat 5: mrdust1 folded before Flop (didn't bet)
Seat 6: Mab471 (button) collected ($5)


PokerStars Hand #232993687097:  Hold'em No Limit ($1/$2 USD) - 2022/01/16 14:25:01 ET
Table 'Atalante' 6-max Seat #1 is the button
Seat 1: MiltonBradley ($200 in chips)
Seat 3: bazman125 ($348.35 in chips)
Seat 4: reynaldo1244 ($327.79 in chips)
Seat 5: mrdust1 ($338.41 in chips)
Seat 6: Mab471 ($203 in chips)
bazman125: posts small blind $1
reynaldo1244: posts big blind $2
*** HOLE CARDS ***
mrdust1: folds
Mab471: raises $3 to $5
MiltonBradley: folds
bazman125: folds
reynaldo1244: calls $3
*** FLOP *** [3d Jd Ac]
reynaldo1244: bets $5.23
Mab471: calls $5.23
*** TURN *** [3d Jd Ac] [4s]
reynaldo1244: checks
Mab471: checks
*** RIVER *** [3d Jd Ac 4s] [3s]
reynaldo1244: checks
Mab471: bets $13.46
reynaldo1244: folds
Uncalled bet ($13.46) returned to Mab471
Mab471 collected $20.39 from pot
Mab471: doesn't show hand
*** SUMMARY ***
Total pot $21.46 | Rake $1.07
Board [3d Jd Ac 4s 3s]
Seat 1: MiltonBradley (button) folded before Flop (didn't bet)
Seat 3: bazman125 (small blind) folded before Flop
Seat 4: reynaldo1244 (big blind) folded on the River
Seat 5: mrdust1 folded before Flop (didn't bet)
Seat 6: Mab471 collected ($20.39)


PokerStars Hand #232993687500:  Hold'em No Limit ($1/$2 USD) - 2022/01/16 14:25:57 ET
Table 'Atalante' 6-max Seat #3 is the button
Seat 1: MiltonBradley ($200 in chips)
Seat 3: bazman125 ($347.35 in chips)
Seat 4: reynaldo1244 ($317.56 in chips)
Seat 5: mrdust1 ($338.41 in chips)
Seat 6: Mab471 ($213.16 in chips)
reynaldo1244: posts small blind $1
mrdust1: posts big blind $2
*** HOLE CARDS ***
Mab471: folds
MiltonBradley: folds
bazman125: folds
reynaldo1244: folds
Uncalled bet ($1) returned to mrdust1
mrdust1 collected $2 from pot
mrdust1: doesn't show hand
*** SUMMARY ***
Total pot $2 | Rake $0
Seat 1: MiltonBradley folded before Flop (didn't bet)
Seat 3: bazman125 (button) folded before Flop (didn't bet)
Seat 4: reynaldo1244 (small blind) folded before Flop
Seat 5: mrdust1 (big blind) collected ($2)
Seat 6: Mab471 folded before Flop (didn't bet)


PokerStars Hand #232993687569:  Hold'em No Limit ($1/$2 USD) - 2022/01/16 14:26:07 ET
Table 'Atalante' 6-max Seat #4 is the button
Seat 1: MiltonBradley ($200 in chips)
Seat 3: bazman125 ($347.35 in chips)
Seat 4: reynaldo1244 ($316.56 in chips)
Seat 5: mrdust1 ($339.41 in chips)
Seat 6: Mab471 ($213.16 in chips)
mrdust1: posts small blind $1
Mab471: posts big blind $2
*** HOLE CARDS ***
MiltonBradley: folds
bazman125: calls $2
reynaldo1244: folds
mrdust1: raises $6 to $8
Mab471: folds
bazman125: folds
Uncalled bet ($6) returned to mrdust1
mrdust1 collected $6 from pot
mrdust1: doesn't show hand
*** SUMMARY ***
Total pot $6 | Rake $0
Seat 1: MiltonBradley folded before Flop (didn't bet)
Seat 3: bazman125 folded before Flop
Seat 4: reynaldo1244 (button) folded before Flop (didn't bet)
Seat 5: mrdust1 (small blind) collected ($6)
Seat 6: Mab471 (big blind) folded before Flop


PokerStars Hand #232993687854:  Hold'em No Limit ($1/$2 USD) - 2022/01/16 14:26:44 ET
Table 'Atalante' 6-max Seat #5 is the button
Seat 1: MiltonBradley ($200 in chips)
Seat 3: bazman125 ($345.35 in chips)
Seat 4: reynaldo1244 ($316.56 in chips)
Seat 5: mrdust1 ($343.41 in chips)
Seat 6: Mab471 ($211.16 in chips)
Mab471: posts small blind $1
MiltonBradley: posts big blind $2
*** HOLE CARDS ***
bazman125: folds
reynaldo1244: folds
mrdust1: folds
Mab471: folds
Uncalled bet ($1) returned to MiltonBradley
MiltonBradley collected $2 from pot
MiltonBradley: doesn't show hand
*** SUMMARY ***
Total pot $2 | Rake $0
Seat 1: MiltonBradley (big blind) collected ($2)
Seat 3: bazman125 folded before Flop (didn't bet)
Seat 4: reynaldo1244 folded before Flop (didn't bet)
Seat 5: mrdust1 (button) folded before Flop (didn't bet)
Seat 6: Mab471 (small blind) folded before Flop


PokerStars Hand #232993687924:  Hold'em No Limit ($1/$2 USD) - 2022/01/16 14:26:54 ET
Table 'Atalante' 6-max Seat #6 is the button
Seat 1: MiltonBradley ($201 in chips)
Seat 3: bazman125 ($345.35 in chips)
Seat 4: reynaldo1244 ($316.56 in chips)
Seat 5: mrdust1 ($343.41 in chips)
Seat 6: Mab471 ($210.16 in chips)
MiltonBradley: posts small blind $1
bazman125: posts big blind $2
*** HOLE CARDS ***
reynaldo1244: folds
mrdust1: folds
Mab471: folds
MiltonBradley: folds
Uncalled bet ($1) returned to bazman125
bazman125 collected $2 from pot
*** SUMMARY ***
Total pot $2 | Rake $0
Seat 1: MiltonBradley (small blind) folded before Flop
Seat 3: bazman125 (big blind) collected ($2)
Seat 4: reynaldo1244 folded before Flop (didn't bet)
Seat 5: mrdust1 folded before Flop (didn't bet)
Seat 6: Mab471 (button) folded before Flop (didn't bet)


PokerStars Hand #232993687986:  Hold'em No Limit ($1/$2 USD) - 2022/01/16 14:27:03 ET
Table 'Atalante' 6-max Seat #1 is the button
Seat 1: MiltonBradley ($200 in chips)
Seat 3: bazman125 ($346.35 in chips)
Seat 4: reynaldo1244 ($316.56 in chips)
Seat 5: mrdust1 ($343.41 in chips)
Seat 6: Mab471 ($210.16 in chips)
bazman125: posts small blind $1
reynaldo1244: posts big blind $2
*** HOLE CARDS ***
mrdust1: raises $3 to $5
Mab471: raises $11 to $16
MiltonBradley: folds
bazman125: folds
reynaldo1244: folds
mrdust1: folds
Uncalled bet ($11) returned to Mab471
Mab471 collected $13 from pot
Mab471: doesn't show hand
*** SUMMARY ***
Total pot $13 | Rake $0
Seat 1: MiltonBradley (button) folded before Flop (didn't bet)
Seat 3: bazman125 (small blind) folded before Flop
Seat 4: reynaldo1244 (big blind) folded before Flop
Seat 5: mrdust1 folded before Flop
Seat 6: Mab471 collected ($13)


PokerStars Hand #232993688198:  Hold'em No Limit ($1/$2 USD) - 2022/01/16 14:27:36 ET
Table 'Atalante' 6-max Seat #3 is the button
Seat 1: MiltonBradley ($200 in chips)
Seat 3: bazman125 ($345.35 in chips)
Seat 4: reynaldo1244 ($314.56 in chips)
Seat 5: mrdust1 ($338.41 in chips)
Seat 6: Mab471 ($218.16 in chips)
reynaldo1244: posts small blind $1
mrdust1: posts big blind $2
*** HOLE CARDS ***
Mab471: folds
MiltonBradley: folds
bazman125: folds
reynaldo1244: folds
Uncalled bet ($1) returned to mrdust1
mrdust1 collected $2 from pot
mrdust1: doesn't show hand
*** SUMMARY ***
Total pot $2 | Rake $0
Seat 1: MiltonBradley folded before Flop (didn't bet)
Seat 3: bazman125 (button) folded before Flop (didn't bet)
Seat 4: reynaldo1244 (small blind) folded before Flop
Seat 5: mrdust1 (big blind) collected ($2)
Seat 6: Mab471 folded before Flop (didn't bet)


PokerStars Hand #232993688267:  Hold'em No Limit ($1/$2 USD) - 2022/01/16 14:27:46 ET
Table 'Atalante' 6-max Seat #4 is the button
Seat 1: MiltonBradley ($200 in chips)
Seat 3: bazman125 ($345.35 in chips)
Seat 4: reynaldo1244 ($313.56 in chips)
Seat 5: mrdust1 ($339.41 in chips)
Seat 6: Mab471 ($218.16 in chips)
mrdust1: posts small blind $1
Mab471: posts big blind $2
*** HOLE CARDS ***
MiltonBradley: folds
bazman125: folds
reynaldo1244: folds
mrdust1: folds
Uncalled bet ($1) returned to Mab471
Mab471 collected $2 from pot
Mab471: doesn't show hand
*** SUMMARY ***
Total pot $2 | Rake $0
Seat 1: MiltonBradley folded before Flop (didn't bet)
Seat 3: bazman125 folded before Flop (didn't bet)
Seat 4: reynaldo1244 (button) folded before Flop (didn't bet)
Seat 5: mrdust1 (small blind) folded before Flop
Seat 6: Mab471 (big blind) collected ($2)


PokerStars Hand #232993688334:  Hold'em No Limit ($1/$2 USD) - 2022/01/16 14:27:57 ET
Table 'Atalante' 6-max Seat #5 is the button
Seat 1: MiltonBradley ($200 in chips)
Seat 3: bazman125 ($345.35 in chips)
Seat 4: reynaldo1244 ($313.56 in chips)
Seat 5: mrdust1 ($338.41 in chips)
Seat 6: Mab471 ($219.16 in chips)
Mab471: posts small blind $1
MiltonBradley: posts big blind $2
*** HOLE CARDS ***
bazman125: folds
reynaldo1244: raises $3 to $5
mrdust1: folds
Mab471: folds
MiltonBradley: folds
Uncalled bet ($3) returned to reynaldo1244
reynaldo1244 collected $5 from pot
reynaldo1244: doesn't show hand
*** SUMMARY ***
Total pot $5 | Rake $0
Seat 1: MiltonBradley (big blind) folded before Flop
Seat 3: bazman125 folded before Flop (didn't bet)
Seat 4: reynaldo1244 collected ($5)
Seat 5: mrdust1 (button) folded before Flop (didn't bet)
Seat 6: Mab471 (small blind) folded before Flop


PokerStars Hand #232993688472:  Hold'em No Limit ($1/$2 USD) - 2022/01/16 14:28:16 ET
Table 'Atalante' 6-max Seat #6 is the button
Seat 1: MiltonBradley ($200 in chips)
Seat 2: RAZOR99999 ($80 in chips)
Seat 3: bazman125 ($345.35 in chips)
Seat 4: reynaldo1244 ($316.56 in chips)
Seat 5: mrdust1 ($338.41 in chips)
Seat 6: Mab471 ($218.16 in chips)
MiltonBradley: posts small blind $1
RAZOR99999: posts big blind $2
*** HOLE CARDS ***
bazman125: folds
reynaldo1244: folds
mrdust1: folds
Mab471: raises $3 to $5
MiltonBradley: folds
RAZOR99999: folds
Uncalled bet ($3) returned to Mab471
Mab471 collected $5 from pot
Mab471: doesn't show hand
*** SUMMARY ***
Total pot $5 | Rake $0
Seat 1: MiltonBradley (small blind) folded before Flop
Seat 2: RAZOR99999 (big blind) folded before Flop
Seat 3: bazman125 folded before Flop (didn't bet)
Seat 4: reynaldo1244 folded before Flop (didn't bet)
Seat 5: mrdust1 folded before Flop (didn't bet)
Seat 6: Mab471 (button) collected ($5)


PokerStars Hand #232993688712:  Hold'em No Limit ($1/$2 USD) - 2022/01/16 14:28:52 ET
Table 'Atalante' 6-max Seat #1 is the button
Seat 1: MiltonBradley ($200 in chips)
Seat 2: RAZOR99999 ($78 in chips)
Seat 3: bazman125 ($345.35 in chips)
Seat 4: reynaldo1244 ($316.56 in chips)
Seat 5: mrdust1 ($338.41 in chips)
Seat 6: Mab471 ($221.16 in chips)
RAZOR99999: posts small blind $1
bazman125: posts big blind $2
*** HOLE CARDS ***
reynaldo1244: folds
mrdust1: folds
Mab471: folds
MiltonBradley: raises $2.42 to $4.42
RAZOR99999: folds
bazman125: calls $2.42
*** FLOP *** [7h Jd 5c]
bazman125: checks
MiltonBradley: checks
*** TURN *** [7h Jd 5c] [7d]
bazman125: bets $2
MiltonBradley: calls $2
*** RIVER *** [7h Jd 5c 7d] [8c]
bazman125: checks
MiltonBradley: checks
*** SHOW DOWN ***
bazman125: shows [2h 5h] (two pair, Sevens and Fives)
MiltonBradley: shows [Kd 8d] (two pair, Eights and Sevens)
MiltonBradley collected $13.15 from pot
*** SUMMARY ***
Total pot $13.84 | Rake $0.69
Board [7h Jd 5c 7d 8c]
Seat 1: MiltonBradley (button) showed [Kd 8d] and won ($13.15) with two pair, Eights and Sevens
Seat 2: RAZOR99999 (small blind) folded before Flop
Seat 3: bazman125 (big blind) showed [2h 5h] and lost with two pair, Sevens and Fives
Seat 4: reynaldo1244 folded before Flop (didn't bet)
Seat 5: mrdust1 folded before Flop (didn't bet)
Seat 6: Mab471 folded before Flop (didn't bet)


PokerStars Hand #232993689038:  Hold'em No Limit ($1/$2 USD) - 2022/01/16 14:29:43 ET
Table 'Atalante' 6-max Seat #2 is the button
Seat 1: MiltonBradley ($206.73 in chips)
Seat 2: RAZOR99999 ($77 in chips)
Seat 3: bazman125 ($338.93 in chips)
Seat 4: reynaldo1244 ($316.56 in chips)
Seat 5: mrdust1 ($338.41 in chips)
Seat 6: Mab471 ($221.16 in chips)
bazman125: posts small blind $1
reynaldo1244: posts big blind $2
*** HOLE CARDS ***
mrdust1: raises $3 to $5
Mab471: folds
MiltonBradley: folds
RAZOR99999: folds
bazman125: calls $4
reynaldo1244: calls $3
*** FLOP *** [9s Kh 8d]
bazman125: checks
reynaldo1244: checks
mrdust1: bets $4.70
bazman125: folds
reynaldo1244: calls $4.70
*** TURN *** [9s Kh 8d] [9d]
reynaldo1244: checks
mrdust1: bets $17.62
reynaldo1244: calls $17.62
*** RIVER *** [9s Kh 8d 9d] [4s]
reynaldo1244: checks
mrdust1: checks
*** SHOW DOWN ***
reynaldo1244: shows [Ks Qd] (two pair, Kings and Nines)
mrdust1: mucks hand
reynaldo1244 collected $56.66 from pot
*** SUMMARY ***
Total pot $59.64 | Rake $2.98
Board [9s Kh 8d 9d 4s]
Seat 1: MiltonBradley folded before Flop (didn't bet)
Seat 2: RAZOR99999 (button) folded before Flop (didn't bet)
Seat 3: bazman125 (small blind) folded on the Flop
Seat 4: reynaldo1244 (big blind) showed [Ks Qd] and won ($56.66) with two pair, Kings and Nines
Seat 5: mrdust1 mucked
Seat 6: Mab471 folded before Flop (didn't bet)


PokerStars Hand #232993689502:  Hold'em No Limit ($1/$2 USD) - 2022/01/16 14:30:57 ET
Table 'Atalante' 6-max Seat #3 is the button
Seat 1: MiltonBradley ($206.73 in chips)
Seat 2: RAZOR99999 ($77 in chips)
Seat 3: bazman125 ($333.93 in chips)
Seat 4: reynaldo1244 ($345.90 in chips)
Seat 5: mrdust1 ($311.09 in chips)
Seat 6: Mab471 ($221.16 in chips)
reynaldo1244: posts small blind $1
mrdust1: posts big blind $2
*** HOLE CARDS ***
Mab471: folds
MiltonBradley: folds
RAZOR99999: folds
bazman125: calls $2
reynaldo1244: raises $8 to $10
mrdust1: raises $20 to $30
bazman125: folds
reynaldo1244: folds
Uncalled bet ($20) returned to mrdust1
mrdust1 collected $22 from pot
mrdust1: doesn't show hand
*** SUMMARY ***
Total pot $22 | Rake $0
Seat 1: MiltonBradley folded before Flop (didn't bet)
Seat 2: RAZOR99999 folded before Flop (didn't bet)
Seat 3: bazman125 (button) folded before Flop
Seat 4: reynaldo1244 (small blind) folded before Flop
Seat 5: mrdust1 (big blind) collected ($22)
Seat 6: Mab471 folded before Flop (didn't bet)


PokerStars Hand #232993689778:  Hold'em No Limit ($1/$2 USD) - 2022/01/16 14:31:35 ET
Table 'Atalante' 6-max Seat #4 is the button
Seat 1: MiltonBradley ($206.73 in chips)
Seat 2: RAZOR99999 ($77 in chips)
Seat 3: bazman125 ($331.93 in chips)
Seat 4: reynaldo1244 ($335.90 in chips)
Seat 5: mrdust1 ($323.09 in chips)
Seat 6: Mab471 ($221.16 in chips)
mrdust1: posts small blind $1
Mab471: posts big blind $2
*** HOLE CARDS ***
MiltonBradley: folds
RAZOR99999: raises $4 to $6
bazman125: folds
reynaldo1244: folds
mrdust1: folds
Mab471: folds
Uncalled bet ($4) returned to RAZOR99999
RAZOR99999 collected $5 from pot
RAZOR99999: doesn't show hand
*** SUMMARY ***
Total pot $5 | Rake $0
Seat 1: MiltonBradley folded before Flop (didn't bet)
Seat 2: RAZOR99999 collected ($5)
Seat 3: bazman125 folded before Flop (didn't bet)
Seat 4: reynaldo1244 (button) folded before Flop (didn't bet)
Seat 5: mrdust1 (small blind) folded before Flop
Seat 6: Mab471 (big blind) folded before Flop


PokerStars Hand #232993840435:  Hold'em No Limit ($1/$2 USD) - 2022/01/16 14:32:14 ET
Table 'Atalante' 6-max Seat #5 is the button
Seat 1: MiltonBradley ($206.73 in chips)
Seat 2: RAZOR99999 ($80 in chips)
Seat 3: bazman125 ($331.93 in chips)
Seat 4: reynaldo1244 ($335.90 in chips)
Seat 5: mrdust1 ($322.09 in chips)
Seat 6: Mab471 ($219.16 in chips)
Mab471: posts small blind $1
MiltonBradley: posts big blind $2
*** HOLE CARDS ***
RAZOR99999: folds
bazman125: folds
reynaldo1244: folds
mrdust1: folds
Mab471: folds
Uncalled bet ($1) returned to MiltonBradley
MiltonBradley collected $2 from pot
MiltonBradley: doesn't show hand
*** SUMMARY ***
Total pot $2 | Rake $0
Seat 1: MiltonBradley (big blind) collected ($2)
Seat 2: RAZOR99999 folded before Flop (didn't bet)
Seat 3: bazman125 folded before Flop (didn't bet)
Seat 4: reynaldo1244 folded before Flop (didn't bet)
Seat 5: mrdust1 (button) folded before Flop (didn't bet)
Seat 6: Mab471 (small blind) folded before Flop


PokerStars Hand #232993840586:  Hold'em No Limit ($1/$2 USD) - 2022/01/16 14:32:36 ET
Table 'Atalante' 6-max Seat #6 is the button
Seat 1: MiltonBradley ($207.73 in chips)
Seat 2: RAZOR99999 ($80 in chips)
Seat 3: bazman125 ($331.93 in chips)
Seat 4: reynaldo1244 ($335.90 in chips)
Seat 5: mrdust1 ($322.09 in chips)
Seat 6: Mab471 ($218.16 in chips)
MiltonBradley: posts small blind $1
RAZOR99999: posts big blind $2
*** HOLE CARDS ***
bazman125: calls $2
reynaldo1244: folds
mrdust1: folds
Mab471: folds
MiltonBradley: calls $1
RAZOR99999: checks
*** FLOP *** [Tc 3d 9c]
MiltonBradley: checks
RAZOR99999: checks
bazman125: checks
*** TURN *** [Tc 3d 9c] [7d]
MiltonBradley: bets $4.45
RAZOR99999: calls $4.45
bazman125: raises $11.55 to $16
MiltonBradley: calls $11.55
RAZOR99999: calls $11.55
*** RIVER *** [Tc 3d 9c 7d] [Ac]
MiltonBradley: checks
RAZOR99999: bets $25
bazman125: calls $25
MiltonBradley: raises $164.73 to $189.73 and is all-in
RAZOR99999: calls $37 and is all-in
bazman125: folds [Ts Td]
Uncalled bet ($127.73) returned to MiltonBradley
*** SHOW DOWN ***
MiltonBradley: shows [2c Kc] (a flush, Ace high)
RAZOR99999: shows [8c Qc] (a flush, Ace high - lower cards)
MiltonBradley collected $200 from pot
*** SUMMARY ***
Total pot $203 | Rake $3
Board [Tc 3d 9c 7d Ac]
Seat 1: MiltonBradley (small blind) showed [2c Kc] and won ($200) with a flush, Ace high
Seat 2: RAZOR99999 (big blind) showed [8c Qc] and lost with a flush, Ace high
Seat 3: bazman125 folded on the River
Seat 4: reynaldo1244 folded before Flop (didn't bet)
Seat 5: mrdust1 folded before Flop (didn't bet)
Seat 6: Mab471 (button) folded before Flop (didn't bet)


PokerStars Hand #232993841459:  Hold'em No Limit ($1/$2 USD) - 2022/01/16 14:34:46 ET
Table 'Atalante' 6-max Seat #1 is the button
Seat 1: MiltonBradley ($327.73 in chips)
Seat 3: bazman125 ($288.93 in chips)
Seat 4: reynaldo1244 ($335.90 in chips)
Seat 5: mrdust1 ($322.09 in chips)
Seat 6: Mab471 ($218.16 in chips)
bazman125: posts small blind $1
reynaldo1244: posts big blind $2
*** HOLE CARDS ***
mrdust1: folds
Mab471: folds
MiltonBradley: folds
bazman125 said, "lol"
bazman125: raises $2 to $4
reynaldo1244: calls $2
*** FLOP *** [Th Qs 5d]
bazman125: bets $2
reynaldo1244: calls $2
*** TURN *** [Th Qs 5d] [As]
bazman125: bets $11.40
reynaldo1244: folds
Uncalled bet ($11.40) returned to bazman125
bazman125 collected $11.40 from pot
*** SUMMARY ***
Total pot $12 | Rake $0.60
Board [Th Qs 5d As]
Seat 1: MiltonBradley (button) folded before Flop (didn't bet)
Seat 3: bazman125 (small blind) collected ($11.40)
Seat 4: reynaldo1244 (big blind) folded on the Turn
Seat 5: mrdust1 folded before Flop (didn't bet)
Seat 6: Mab471 folded before Flop (didn't bet)


PokerStars Hand #232993841681:  Hold'em No Limit ($1/$2 USD) - 2022/01/16 14:35:21 ET
Table 'Atalante' 6-max Seat #3 is the button
Seat 1: MiltonBradley ($327.73 in chips)
Seat 3: bazman125 ($294.33 in chips)
Seat 4: reynaldo1244 ($329.90 in chips)
Seat 5: mrdust1 ($322.09 in chips)
Seat 6: Mab471 ($218.16 in chips)
reynaldo1244: posts small blind $1
mrdust1: posts big blind $2
*** HOLE CARDS ***
Mab471: folds
MiltonBradley: folds
bazman125: folds
reynaldo1244: folds
Uncalled bet ($1) returned to mrdust1
mrdust1 collected $2 from pot
mrdust1: doesn't show hand
*** SUMMARY ***
Total pot $2 | Rake $0
Seat 1: MiltonBradley folded before Flop (didn't bet)
Seat 3: bazman125 (button) folded before Flop (didn't bet)
Seat 4: reynaldo1244 (small blind) folded before Flop
Seat 5: mrdust1 (big blind) collected ($2)
Seat 6: Mab471 folded before Flop (didn't bet)


PokerStars Hand #232993841756:  Hold'em No Limit ($1/$2 USD) - 2022/01/16 14:35:32 ET
Table 'Atalante' 6-max Seat #4 is the button
Seat 1: MiltonBradley ($327.73 in chips)
Seat 3: bazman125 ($294.33 in chips)
Seat 4: reynaldo1244 ($328.90 in chips)
Seat 5: mrdust1 ($323.09 in chips)
Seat 6: Mab471 ($218.16 in chips)
mrdust1: posts small blind $1
Mab471: posts big blind $2
*** HOLE CARDS ***
MiltonBradley: folds
bazman125: folds
reynaldo1244: raises $3 to $5
mrdust1: folds
Mab471: calls $3
*** FLOP *** [3s Kh 5d]
Mab471: checks
reynaldo1244: bets $5.23
Mab471: folds
Uncalled bet ($5.23) returned to reynaldo1244
reynaldo1244 collected $10.45 from pot
reynaldo1244: doesn't show hand
*** SUMMARY ***
Total pot $11 | Rake $0.55
Board [3s Kh 5d]
Seat 1: MiltonBradley folded before Flop (didn't bet)
Seat 3: bazman125 folded before Flop (didn't bet)
Seat 4: reynaldo1244 (button) collected ($10.45)
Seat 5: mrdust1 (small blind) folded before Flop
Seat 6: Mab471 (big blind) folded on the Flop


PokerStars Hand #232993841938:  Hold'em No Limit ($1/$2 USD) - 2022/01/16 14:36:00 ET
Table 'Atalante' 6-max Seat #5 is the button
Seat 1: MiltonBradley ($327.73 in chips)
Seat 3: bazman125 ($294.33 in chips)
Seat 4: reynaldo1244 ($334.35 in chips)
Seat 5: mrdust1 ($322.09 in chips)
Seat 6: Mab471 ($213.16 in chips)
Mab471: posts small blind $1
MiltonBradley: posts big blind $2
*** HOLE CARDS ***
bazman125: calls $2
reynaldo1244: folds
mrdust1: folds
Mab471: folds
MiltonBradley: checks
*** FLOP *** [5c 4d 2c]
MiltonBradley: checks
bazman125: checks
*** TURN *** [5c 4d 2c] [Qs]
MiltonBradley: checks
bazman125: checks
*** RIVER *** [5c 4d 2c Qs] [Jd]
MiltonBradley: bets $3.71
bazman125: calls $3.71
*** SHOW DOWN ***
MiltonBradley: shows [8s 9c] (high card Queen)
bazman125: shows [Jc Ah] (a pair of Jacks)
bazman125 collected $11.80 from pot
*** SUMMARY ***
Total pot $12.42 | Rake $0.62
Board [5c 4d 2c Qs Jd]
Seat 1: MiltonBradley (big blind) showed [8s 9c] and lost with high card Queen
Seat 3: bazman125 showed [Jc Ah] and won ($11.80) with a pair of Jacks
Seat 4: reynaldo1244 folded before Flop (didn't bet)
Seat 5: mrdust1 (button) folded before Flop (didn't bet)
Seat 6: Mab471 (small blind) folded before Flop


PokerStars Hand #232993842211:  Hold'em No Limit ($1/$2 USD) - 2022/01/16 14:36:41 ET
Table 'Atalante' 6-max Seat #6 is the button
Seat 1: MiltonBradley ($322.02 in chips)
Seat 3: bazman125 ($300.42 in chips)
Seat 4: reynaldo1244 ($334.35 in chips)
Seat 5: mrdust1 ($322.09 in chips)
Seat 6: Mab471 ($212.16 in chips)
MiltonBradley: posts small blind $1
bazman125: posts big blind $2
*** HOLE CARDS ***
reynaldo1244: raises $3 to $5
mrdust1: folds
Mab471: folds
MiltonBradley: folds
bazman125: calls $3
*** FLOP *** [3s 3c 3h]
bazman125: bets $2
reynaldo1244: raises $8 to $10
bazman125: folds
Uncalled bet ($8) returned to reynaldo1244
reynaldo1244 collected $14.25 from pot
reynaldo1244: doesn't show hand
*** SUMMARY ***
Total pot $15 | Rake $0.75
Board [3s 3c 3h]
Seat 1: MiltonBradley (small blind) folded before Flop
Seat 3: bazman125 (big blind) folded on the Flop
Seat 4: reynaldo1244 collected ($14.25)
Seat 5: mrdust1 folded before Flop (didn't bet)
Seat 6: Mab471 (button) folded before Flop (didn't bet)


PokerStars Hand #232993842365:  Hold'em No Limit ($1/$2 USD) - 2022/01/16 14:37:06 ET
Table 'Atalante' 6-max Seat #1 is the button
Seat 1: MiltonBradley ($321.02 in chips)
Seat 3: bazman125 ($293.42 in chips)
Seat 4: reynaldo1244 ($341.60 in chips)
Seat 5: mrdust1 ($322.09 in chips)
Seat 6: Mab471 ($212.16 in chips)
bazman125: posts small blind $1
reynaldo1244: posts big blind $2
*** HOLE CARDS ***
mrdust1: raises $3 to $5
Mab471: folds
MiltonBradley: folds
bazman125: folds
reynaldo1244: folds
Uncalled bet ($3) returned to mrdust1
mrdust1 collected $5 from pot
mrdust1: doesn't show hand
*** SUMMARY ***
Total pot $5 | Rake $0
Seat 1: MiltonBradley (button) folded before Flop (didn't bet)
Seat 3: bazman125 (small blind) folded before Flop
Seat 4: reynaldo1244 (big blind) folded before Flop
Seat 5: mrdust1 collected ($5)
Seat 6: Mab471 folded before Flop (didn't bet)


PokerStars Hand #232993842480:  Hold'em No Limit ($1/$2 USD) - 2022/01/16 14:37:24 ET
Table 'Atalante' 6-max Seat #3 is the button
Seat 1: MiltonBradley ($321.02 in chips)
Seat 3: bazman125 ($292.42 in chips)
Seat 4: reynaldo1244 ($339.60 in chips)
Seat 5: mrdust1 ($325.09 in chips)
Seat 6: Mab471 ($212.16 in chips)
reynaldo1244: posts small blind $1
mrdust1: posts big blind $2
*** HOLE CARDS ***
Mab471: folds
MiltonBradley: folds
bazman125: folds
reynaldo1244: folds
Uncalled bet ($1) returned to mrdust1
mrdust1 collected $2 from pot
mrdust1: doesn't show hand
*** SUMMARY ***
Total pot $2 | Rake $0
Seat 1: MiltonBradley folded before Flop (didn't bet)
Seat 3: bazman125 (button) folded before Flop (didn't bet)
Seat 4: reynaldo1244 (small blind) folded before Flop
Seat 5: mrdust1 (big blind) collected ($2)
Seat 6: Mab471 folded before Flop (didn't bet)


PokerStars Hand #232993842553:  Hold'em No Limit ($1/$2 USD) - 2022/01/16 14:37:35 ET
Table 'Atalante' 6-max Seat #4 is the button
Seat 1: MiltonBradley ($321.02 in chips)
Seat 3: bazman125 ($292.42 in chips)
Seat 4: reynaldo1244 ($338.60 in chips)
Seat 5: mrdust1 ($326.09 in chips)
Seat 6: Mab471 ($212.16 in chips)
mrdust1: posts small blind $1
Mab471: posts big blind $2
*** HOLE CARDS ***
MiltonBradley: raises $2.42 to $4.42
bazman125: folds
reynaldo1244: folds
mrdust1: folds
Mab471: folds
Uncalled bet ($2.42) returned to MiltonBradley
MiltonBradley collected $5 from pot
MiltonBradley: doesn't show hand
*** SUMMARY ***
Total pot $5 | Rake $0
Seat 1: MiltonBradley collected ($5)
Seat 3: bazman125 folded before Flop (didn't bet)
Seat 4: reynaldo1244 (button) folded before Flop (didn't bet)
Seat 5: mrdust1 (small blind) folded before Flop
Seat 6: Mab471 (big blind) folded before Flop


PokerStars Hand #232993842624:  Hold'em No Limit ($1/$2 USD) - 2022/01/16 14:37:46 ET
Table 'Atalante' 6-max Seat #5 is the button
Seat 1: MiltonBradley ($324.02 in chips)
Seat 3: bazman125 ($292.42 in chips)
Seat 4: reynaldo1244 ($338.60 in chips)
Seat 5: mrdust1 ($325.09 in chips)
Seat 6: Mab471 ($210.16 in chips)
Mab471: posts small blind $1
MiltonBradley: posts big blind $2
*** HOLE CARDS ***
bazman125: folds
reynaldo1244: folds
mrdust1: raises $3 to $5
Mab471: folds
MiltonBradley: folds
Uncalled bet ($3) returned to mrdust1
mrdust1 collected $5 from pot
mrdust1: doesn't show hand
*** SUMMARY ***
Total pot $5 | Rake $0
Seat 1: MiltonBradley (big blind) folded before Flop
Seat 3: bazman125 folded before Flop (didn't bet)
Seat 4: reynaldo1244 folded before Flop (didn't bet)
Seat 5: mrdust1 (button) collected ($5)
Seat 6: Mab471 (small blind) folded before Flop


PokerStars Hand #232993842772:  Hold'em No Limit ($1/$2 USD) - 2022/01/16 14:38:09 ET
Table 'Atalante' 6-max Seat #6 is the button
Seat 1: MiltonBradley ($322.02 in chips)
Seat 3: bazman125 ($292.42 in chips)
Seat 4: reynaldo1244 ($338.60 in chips)
Seat 5: mrdust1 ($328.09 in chips)
Seat 6: Mab471 ($209.16 in chips)
MiltonBradley: posts small blind $1
bazman125: posts big blind $2
*** HOLE CARDS ***
reynaldo1244: folds
mrdust1: folds
Mab471: raises $3 to $5
MiltonBradley: folds
bazman125: folds
Uncalled bet ($3) returned to Mab471
Mab471 collected $5 from pot
Mab471: doesn't show hand
*** SUMMARY ***
Total pot $5 | Rake $0
Seat 1: MiltonBradley (small blind) folded before Flop
Seat 3: bazman125 (big blind) folded before Flop
Seat 4: reynaldo1244 folded before Flop (didn't bet)
Seat 5: mrdust1 folded before Flop (didn't bet)
Seat 6: Mab471 (button) collected ($5)


PokerStars Hand #232993842861:  Hold'em No Limit ($1/$2 USD) - 2022/01/16 14:38:23 ET
Table 'Atalante' 6-max Seat #1 is the button
Seat 1: MiltonBradley ($321.02 in chips)
Seat 3: bazman125 ($290.42 in chips)
Seat 4: reynaldo1244 ($338.60 in chips)
Seat 5: mrdust1 ($328.09 in chips)
Seat 6: Mab471 ($212.16 in chips)
bazman125: posts small blind $1
reynaldo1244: posts big blind $2
*** HOLE CARDS ***
mrdust1: folds
Mab471: folds
MiltonBradley: raises $2.42 to $4.42
bazman125: folds
RAZOR99999 leaves the table
reynaldo1244: folds
Uncalled bet ($2.42) returned to MiltonBradley
MiltonBradley collected $5 from pot
MiltonBradley: doesn't show hand
TheAristotle34 joins the table at seat #2
*** SUMMARY ***
Total pot $5 | Rake $0
Seat 1: MiltonBradley (button) collected ($5)
Seat 3: bazman125 (small blind) folded before Flop
Seat 4: reynaldo1244 (big blind) folded before Flop
Seat 5: mrdust1 folded before Flop (didn't bet)
Seat 6: Mab471 folded before Flop (didn't bet)


PokerStars Hand #232993842983:  Hold'em No Limit ($1/$2 USD) - 2022/01/16 14:38:43 ET
Table 'Atalante' 6-max Seat #3 is the button
Seat 1: MiltonBradley ($324.02 in chips)
Seat 3: bazman125 ($289.42 in chips)
Seat 4: reynaldo1244 ($336.60 in chips)
Seat 5: mrdust1 ($328.09 in chips)
Seat 6: Mab471 ($212.16 in chips)
reynaldo1244: posts small blind $1
mrdust1: posts big blind $2
TheAristotle34: sits out
*** HOLE CARDS ***
Mab471: folds
MiltonBradley: folds
bazman125: folds
reynaldo1244: folds
Uncalled bet ($1) returned to mrdust1
mrdust1 collected $2 from pot
mrdust1: doesn't show hand
*** SUMMARY ***
Total pot $2 | Rake $0
Seat 1: MiltonBradley folded before Flop (didn't bet)
Seat 3: bazman125 (button) folded before Flop (didn't bet)
Seat 4: reynaldo1244 (small blind) folded before Flop
Seat 5: mrdust1 (big blind) collected ($2)
Seat 6: Mab471 folded before Flop (didn't bet)


PokerStars Hand #232993843077:  Hold'em No Limit ($1/$2 USD) - 2022/01/16 14:38:56 ET
Table 'Atalante' 6-max Seat #4 is the button
Seat 1: MiltonBradley ($324.02 in chips)
Seat 3: bazman125 ($289.42 in chips)
Seat 4: reynaldo1244 ($335.60 in chips)
Seat 5: mrdust1 ($329.09 in chips)
mrdust1: posts small blind $1
Mab471: is sitting out
MiltonBradley: posts big blind $2
TheAristotle34: sits out
*** HOLE CARDS ***
bazman125: calls $2
reynaldo1244: folds
mrdust1: folds
MiltonBradley: checks
*** FLOP *** [6d 3s 7d]
MiltonBradley: bets $3.71
bazman125: folds
Uncalled bet ($3.71) returned to MiltonBradley
MiltonBradley collected $4.75 from pot
MiltonBradley: doesn't show hand
*** SUMMARY ***
Total pot $5 | Rake $0.25
Board [6d 3s 7d]
Seat 1: MiltonBradley (big blind) collected ($4.75)
Seat 3: bazman125 folded on the Flop
Seat 4: reynaldo1244 (button) folded before Flop (didn't bet)
Seat 5: mrdust1 (small blind) folded before Flop


PokerStars Hand #232993843201:  Hold'em No Limit ($1/$2 USD) - 2022/01/16 14:39:17 ET
Table 'Atalante' 6-max Seat #5 is the button
Seat 1: MiltonBradley ($326.77 in chips)
Seat 2: TheAristotle34 ($200 in chips)
Seat 3: bazman125 ($287.42 in chips)
Seat 4: reynaldo1244 ($335.60 in chips)
Seat 5: mrdust1 ($328.09 in chips)
MiltonBradley: posts small blind $1
TheAristotle34: posts big blind $2
*** HOLE CARDS ***
bazman125: folds
reynaldo1244: raises $3 to $5
bazman125 leaves the table
mrdust1: folds
MiltonBradley: folds
TheAristotle34: folds
Uncalled bet ($3) returned to reynaldo1244
reynaldo1244 collected $5 from pot
reynaldo1244: doesn't show hand
*** SUMMARY ***
Total pot $5 | Rake $0
Seat 1: MiltonBradley (small blind) folded before Flop
Seat 2: TheAristotle34 (big blind) folded before Flop
Seat 3: bazman125 folded before Flop (didn't bet)
Seat 4: reynaldo1244 collected ($5)
Seat 5: mrdust1 (button) folded before Flop (didn't bet)


PokerStars Hand #232993843421:  Hold'em No Limit ($1/$2 USD) - 2022/01/16 14:39:51 ET
Table 'Atalante' 6-max Seat #1 is the button
Seat 1: MiltonBradley ($325.77 in chips)
Seat 2: TheAristotle34 ($200 in chips)
Seat 4: reynaldo1244 ($338.60 in chips)
Seat 5: mrdust1 ($328.09 in chips)
TheAristotle34: posts small blind $1
reynaldo1244: posts big blind $2
*** HOLE CARDS ***
mrdust1: folds
MiltonBradley: folds
TheAristotle34: raises $4 to $6
reynaldo1244: folds
Uncalled bet ($4) returned to TheAristotle34
TheAristotle34 collected $4 from pot
TheAristotle34: doesn't show hand
*** SUMMARY ***
Total pot $4 | Rake $0
Seat 1: MiltonBradley (button) folded before Flop (didn't bet)
Seat 2: TheAristotle34 (small blind) collected ($4)
Seat 4: reynaldo1244 (big blind) folded before Flop
Seat 5: mrdust1 folded before Flop (didn't bet)


PokerStars Hand #232993843522:  Hold'em No Limit ($1/$2 USD) - 2022/01/16 14:40:04 ET
Table 'Atalante' 6-max Seat #2 is the button
Seat 1: MiltonBradley ($325.77 in chips)
Seat 2: TheAristotle34 ($202 in chips)
Seat 4: reynaldo1244 ($336.60 in chips)
Seat 5: mrdust1 ($328.09 in chips)
reynaldo1244: posts small blind $1
mrdust1: posts big blind $2
*** HOLE CARDS ***
MiltonBradley: folds
TheAristotle34: folds
reynaldo1244: folds
Uncalled bet ($1) returned to mrdust1
mrdust1 collected $2 from pot
mrdust1: doesn't show hand
*** SUMMARY ***
Total pot $2 | Rake $0
Seat 1: MiltonBradley folded before Flop (didn't bet)
Seat 2: TheAristotle34 (button) folded before Flop (didn't bet)
Seat 4: reynaldo1244 (small blind) folded before Flop
Seat 5: mrdust1 (big blind) collected ($2)


PokerStars Hand #232993843564:  Hold'em No Limit ($1/$2 USD) - 2022/01/16 14:40:11 ET
Table 'Atalante' 6-max Seat #4 is the button
Seat 1: MiltonBradley ($325.77 in chips)
Seat 2: TheAristotle34 ($202 in chips)
Seat 4: reynaldo1244 ($335.60 in chips)
Seat 5: mrdust1 ($329.09 in chips)
mrdust1: posts small blind $1
MiltonBradley: posts big blind $2
*** HOLE CARDS ***
Mab471 leaves the table
TheAristotle34: folds
reynaldo1244: folds
mrdust1: raises $4.60 to $6.60
MiltonBradley: calls $4.60
*** FLOP *** [8h 2h Ah]
mrdust1: checks
MiltonBradley: bets $4.26
mrdust1: calls $4.26
*** TURN *** [8h 2h Ah] [6d]
mrdust1: checks
TheAristotle34 is disconnected
MiltonBradley: bets $7.01
TheAristotle34 is disconnected
mrdust1: raises $22.99 to $30
MiltonBradley: folds
Uncalled bet ($22.99) returned to mrdust1
mrdust1 collected $33.95 from pot
mrdust1: doesn't show hand
*** SUMMARY ***
Total pot $35.74 | Rake $1.79
Board [8h 2h Ah 6d]
Seat 1: MiltonBradley (big blind) folded on the Turn
Seat 2: TheAristotle34 folded before Flop (didn't bet)
Seat 4: reynaldo1244 (button) folded before Flop (didn't bet)
Seat 5: mrdust1 (small blind) collected ($33.95)


PokerStars Hand #232993844072:  Hold'em No Limit ($1/$2 USD) - 2022/01/16 14:41:24 ET
Table 'Atalante' 6-max Seat #5 is the button
Seat 1: MiltonBradley ($307.90 in chips)
Seat 2: TheAristotle34 ($202 in chips)
Seat 4: reynaldo1244 ($335.60 in chips)
Seat 5: mrdust1 ($345.17 in chips)
MiltonBradley: posts small blind $1
TheAristotle34: posts big blind $2
*** HOLE CARDS ***
reynaldo1244: folds
mrdust1: folds
MiltonBradley: raises $4 to $6
TheAristotle34: calls $4
*** FLOP *** [Qc 5d 9d]
MiltonBradley: checks
TheAristotle34: checks
*** TURN *** [Qc 5d 9d] [8s]
MiltonBradley: bets $8.66
TheAristotle34: folds
Uncalled bet ($8.66) returned to MiltonBradley
MiltonBradley collected $11.40 from pot
MiltonBradley: doesn't show hand
*** SUMMARY ***
Total pot $12 | Rake $0.60
Board [Qc 5d 9d 8s]
Seat 1: MiltonBradley (small blind) collected ($11.40)
Seat 2: TheAristotle34 (big blind) folded on the Turn
Seat 4: reynaldo1244 folded before Flop (didn't bet)
Seat 5: mrdust1 (button) folded before Flop (didn't bet)


PokerStars Hand #232993844390:  Hold'em No Limit ($1/$2 USD) - 2022/01/16 14:42:07 ET
Table 'Atalante' 6-max Seat #2 is the button
Seat 1: MiltonBradley ($313.30 in chips)
Seat 2: TheAristotle34 ($200 in chips)
Seat 4: reynaldo1244 ($333.60 in chips)
Seat 5: mrdust1 ($348.17 in chips)
reynaldo1244: posts small blind $1
mrdust1: posts big blind $2
*** HOLE CARDS ***
MiltonBradley: folds
TheAristotle34: folds
reynaldo1244: folds
Uncalled bet ($1) returned to mrdust1
mrdust1 collected $2 from pot
mrdust1: doesn't show hand
*** SUMMARY ***
Total pot $2 | Rake $0
Seat 1: MiltonBradley folded before Flop (didn't bet)
Seat 2: TheAristotle34 (button) folded before Flop (didn't bet)
Seat 4: reynaldo1244 (small blind) folded before Flop
Seat 5: mrdust1 (big blind) collected ($2)


PokerStars Hand #232993844268:  Hold'em No Limit ($1/$2 USD) - 2022/01/16 14:41:50 ET
Table 'Atalante' 6-max Seat #1 is the button
Seat 1: MiltonBradley ($313.30 in chips)
Seat 2: TheAristotle34 ($200 in chips)
Seat 4: reynaldo1244 ($335.60 in chips)
Seat 5: mrdust1 ($345.17 in chips)
TheAristotle34: posts small blind $1
reynaldo1244: posts big blind $2
*** HOLE CARDS ***
mrdust1: raises $3 to $5
MiltonBradley: folds
TheAristotle34: folds
reynaldo1244: folds
Uncalled bet ($3) returned to mrdust1
mrdust1 collected $5 from pot
mrdust1: doesn't show hand
*** SUMMARY ***
Total pot $5 | Rake $0
Seat 1: MiltonBradley (button) folded before Flop (didn't bet)
Seat 2: TheAristotle34 (small blind) folded before Flop
Seat 4: reynaldo1244 (big blind) folded before Flop
Seat 5: mrdust1 collected ($5)


PokerStars Hand #232993844431:  Hold'em No Limit ($1/$2 USD) - 2022/01/16 14:42:13 ET
Table 'Atalante' 6-max Seat #4 is the button
Seat 1: MiltonBradley ($313.30 in chips)
Seat 2: TheAristotle34 ($200 in chips)
Seat 4: reynaldo1244 ($332.60 in chips)
Seat 5: mrdust1 ($349.17 in chips)
mrdust1: posts small blind $1
MiltonBradley: posts big blind $2
*** HOLE CARDS ***
TheAristotle34: raises $2.50 to $4.50
reynaldo1244: folds
mrdust1: raises $19.50 to $24
MiltonBradley: folds
TheAristotle34: folds
Uncalled bet ($19.50) returned to mrdust1
mrdust1 collected $11 from pot
mrdust1: doesn't show hand
*** SUMMARY ***
Total pot $11 | Rake $0
Seat 1: MiltonBradley (big blind) folded before Flop
Seat 2: TheAristotle34 folded before Flop
Seat 4: reynaldo1244 (button) folded before Flop (didn't bet)
Seat 5: mrdust1 (small blind) collected ($11)


PokerStars Hand #232993844616:  Hold'em No Limit ($1/$2 USD) - 2022/01/16 14:42:38 ET
Table 'Atalante' 6-max Seat #1 is the button
Seat 1: MiltonBradley ($310.30 in chips)
Seat 2: TheAristotle34 ($200 in chips)
Seat 5: mrdust1 ($358.67 in chips)
TheAristotle34: posts small blind $1
reynaldo1244: is sitting out
mrdust1: posts big blind $2
*** HOLE CARDS ***
MiltonBradley: folds
TheAristotle34: folds
Uncalled bet ($1) returned to mrdust1
mrdust1 collected $2 from pot
mrdust1: doesn't show hand
*** SUMMARY ***
Total pot $2 | Rake $0
Seat 1: MiltonBradley (button) folded before Flop (didn't bet)
Seat 2: TheAristotle34 (small blind) folded before Flop
Seat 5: mrdust1 (big blind) collected ($2)


PokerStars Hand #232993844534:  Hold'em No Limit ($1/$2 USD) - 2022/01/16 14:42:28 ET
Table 'Atalante' 6-max Seat #5 is the button
Seat 1: MiltonBradley ($311.30 in chips)
Seat 2: TheAristotle34 ($200 in chips)
Seat 4: reynaldo1244 ($332.60 in chips)
Seat 5: mrdust1 ($355.67 in chips)
MiltonBradley: posts small blind $1
TheAristotle34: posts big blind $2
*** HOLE CARDS ***
reynaldo1244: folds
mrdust1: raises $3 to $5
MiltonBradley: folds
TheAristotle34: folds
Uncalled bet ($3) returned to mrdust1
mrdust1 collected $5 from pot
mrdust1: doesn't show hand
*** SUMMARY ***
Total pot $5 | Rake $0
Seat 1: MiltonBradley (small blind) folded before Flop
Seat 2: TheAristotle34 (big blind) folded before Flop
Seat 4: reynaldo1244 folded before Flop (didn't bet)
Seat 5: mrdust1 (button) collected ($5)


PokerStars Hand #232993844655:  Hold'em No Limit ($1/$2 USD) - 2022/01/16 14:42:43 ET
Table 'Atalante' 6-max Seat #2 is the button
Seat 1: MiltonBradley ($310.30 in chips)
Seat 2: TheAristotle34 ($200 in chips)
Seat 5: mrdust1 ($359.67 in chips)
mrdust1: posts small blind $1
MiltonBradley: posts big blind $2
*** HOLE CARDS ***
TheAristotle34: folds
mrdust1: raises $4.60 to $6.60
MiltonBradley: folds
Uncalled bet ($4.60) returned to mrdust1
mrdust1 collected $4 from pot
mrdust1: doesn't show hand
*** SUMMARY ***
Total pot $4 | Rake $0
Seat 1: MiltonBradley (big blind) folded before Flop
Seat 2: TheAristotle34 (button) folded before Flop (didn't bet)
Seat 5: mrdust1 (small blind) collected ($4)


PokerStars Hand #232993844728:  Hold'em No Limit ($1/$2 USD) - 2022/01/16 14:42:53 ET
Table 'Atalante' 6-max Seat #5 is the button
Seat 1: MiltonBradley ($308.30 in chips)
Seat 2: TheAristotle34 ($200 in chips)
Seat 5: mrdust1 ($361.67 in chips)
MiltonBradley: posts small blind $1
TheAristotle34: posts big blind $2
*** HOLE CARDS ***
mrdust1: folds
MiltonBradley: folds
Uncalled bet ($1) returned to TheAristotle34
TheAristotle34 collected $2 from pot
TheAristotle34: doesn't show hand
*** SUMMARY ***
Total pot $2 | Rake $0
Seat 1: MiltonBradley (small blind) folded before Flop
Seat 2: TheAristotle34 (big blind) collected ($2)
Seat 5: mrdust1 (button) folded before Flop (didn't bet)


